"name","birth","death","won_award","field","profession","country","age"
"Alexander Grothendieck",1920,"2014",1,"algebraic geometry","mathematician","COL",94
"Johannes Hudde",1620,"1704",0,"mathematics","mathematician","COL",84
"Morris Kline",1900,"1992",1,"mathematics","mathematician","AUS",92
"James Stirling (mathematician)",1690,"1770",1,"combinatorics","mathematician","AUS",80
"Heinrich Wilhelm Brandes",1770,"1834",0,"physics","mathematician","DEU",64
"Chen Jingrun",1930,"1996",0,"number theory","mathematician","CHN",66
"Jan Arnoldus Schouten",1880,"1971",0,"differential geometry","mathematician","COL",91
"James R. Jackson",1920,"2011",0,"queueing theory","mathematician","AUS",91
"Carl Gustav Jacob Jacobi",1800,"1851",1,"differential geometry","mathematician","DEU",51
"R. W. H. T. Hudson",1870,"1904",0,"algebraic geometry","mathematician","AUS",34
"Luigi Cremona",1830,"1903",1,"algebraic geometry","mathematician","COL",73
"Helmut Hasse",1890,"1979",1,"number theory","mathematician","CMR",89
"Nikolai Sergeevich Bakhvalov",1930,"2005",1,"applied mathematics","mathematician","RUS",75
"Solomon W. Golomb",1930,"2016",1,"combinatorics","mathematician","COL",86
"Yehoshua Bar-Hillel",1910,"1975",0,"mathematical logic","mathematician","AUT",65
"Claude Shannon",1910,"2001",1,"probability theory","mathematician","USA",91
"Étienne-Louis Malus",1770,"1812",1,"optics","mathematician","CAN",42
"Børge Jessen",1900,"1993",0,"mathematical analysis","mathematician","DNK",93
"Nail Bakirov",1950,"2010",0,"probability theory","mathematician","KAZ",60
"Erling Sverdrup",1910,"1994",0,"cryptography","mathematician","AUT",84
"Isaac Barrow",1630,"1677",0,"physics","theologian","BLZ",47
"Jacob Tamarkin",1880,"1945",0,"mathematical analysis","mathematician","UKR",65
"Ludwig Boltzmann",1840,"1906",1,"theoretical physics","physicist","AUT",66
"Sandy Green (mathematician)",1920,"2014",1,"group theory","mathematician","AUS",94
"Charles Dupin",1780,"1873",1,"differential geometry","mathematician","FRA",93
"Ivan M. Niven",1910,"1999",0,"number theory","mathematician","CAN",89
"D. D. Morduhai-Boltovskoi",1870,"1952",0,"mathematical analysis","mathematician","KAZ",82
"Anatoly Karatsuba",1930,"2008",1,"mathematical analysis","mathematician","RUS",78
"Tiberiu Popoviciu",1900,"1975",0,"mathematics","mathematician","IRN",75
"Yom Tov Lipman Lipkin",1840,"1876",0,"geometry","mathematician","LTU",36
"Lev Schnirelmann",1900,"1938",0,"number theory","mathematician","BLR",38
"Kurt Leichtweiss",1920,"2013",0,"geometry","mathematician","DEU",93
"Henry P. H. Bromwell",1820,"1903",0,"geometry","mathematician","COL",83
"J. W. S. Cassels",1920,"2015",1,"number theory","mathematician","ARG",95
"Arnaud Denjoy",1880,"1974",1,"mathematics","mathematician","FRA",94
"Jarl Waldemar Lindeberg",1870,"1932",0,"probability theory","mathematician","FIN",62
"Eric Temple Bell",1880,"1960",0,"combinatorics","mathematician","GBR",80
"John Backus",1920,"2007",1,"computer science","mathematician","BRA",87
"Felix Berezin",1930,"1980",0,"algebra","mathematician","RUS",50
"Wilhelm Ackermann",1890,"1962",0,"mathematics","mathematician","DEU",72
"Leonty Magnitsky",1660,"1739",0,"geometry","mathematician","RUS",79
"Ernest Michael",1920,"2013",1,"mathematical analysis","mathematician","CHE",93
"Marcel-Paul Schützenberger",1920,"1996",0,"combinatorics","mathematician","CAN",76
"Evgeny Yakovlevich Remez",1890,"1975",0,"mathematics","mathematician","BLR",85
"Sergey Nikolsky",1900,"2012",1,"functional analysis","mathematician","RUS",112
"John Edensor Littlewood",1880,"1977",1,"mathematical analysis","mathematician","AUS",97
"Yuri Linnik",1910,"1972",1,"number theory","mathematician","UKR",62
"Claude Berge",1920,"2002",1,"graph theory","mathematician","CAN",82
"Charles Sanders Peirce",1830,"1914",0,"lattice","mathematician","AUS",84
"Moritz Cantor",1820,"1920",0,"history","mathematician","DEU",100
"John Hammersley",1920,"2004",1,"probability theory","mathematician","AUS",84
"Saunders Mac Lane",1900,"2005",1,"Q3968","mathematician","USA",105
"Victor Lidskii",1920,"2008",1,"mathematical analysis","mathematician","UKR",88
"Gottfried Wilhelm Leibniz",1640,"1716",1,"mathematical analysis","mathematician","DEU",76
"Viktor Bunyakovsky",1800,"1889",0,"mathematical analysis","mathematician","AFG",89
"Leopold Kronecker",1820,"1891",0,"number theory","mathematician","POL",71
"Vera Kublanovskaya",1920,"2012",0,"Q3968","mathematician","RUS",92
"Yuri Petunin",1930,"2011",0,"mathematical statistics","mathematician","RUS",81
"Gilbert Ames Bliss",1870,"1951",0,"mathematical analysis","mathematician","BLZ",81
"Josiah Willard Gibbs",1830,"1903",1,"mathematical analysis","mathematician","BLZ",73
"Bernhard Neumann",1900,"2002",1,"group theory","mathematician","COL",102
"Sakabe Kohan",1750,"1824",0,"Japanese mathematics","mathematician","IDN",74
"Heinrich Martin Weber",1840,"1913",0,"Q3968","mathematician","AUS",73
"Aleksey Letnikov",1830,"1888",0,"analytic geometry","mathematician","RUS",58
"Andrei Bolibrukh",1950,"2003",0,"mathematical analysis","mathematician","RUS",53
"Arthur Milgram",1910,"1961",0,"mathematical analysis","mathematician","BRA",51
"Mark Naimark",1900,"1978",0,"representation theory","mathematician","UKR",78
"Charles B. Morrey Jr.",1900,"1984",0,"mathematical analysis","mathematician","USA",84
"William Sealy Gosset",1870,"1937",0,"mathematical statistics","statistician","AUS",67
"Klaus Fischer (mathematician)",1940,"2009",0,"group theory","mathematician","CZE",69
"Yakov Geronimus",1890,"1984",0,"mathematical analysis","mathematician","RUS",94
"Sergey Stechkin",1920,"1995",0,"Function theory","mathematician","RUS",75
"Arthur Geoffrey Walker",1900,"2001",1,"differential geometry","mathematician","CAN",101
"Eugene Wigner",1900,"1995",1,"physics","mathematician","HUN",95
"Stanislaw Mazur",1900,"1981",0,"functional analysis","mathematician","UKR",81
"Otto Hölder",1850,"1937",0,"group theory","mathematician","DEU",87
"Henry Helson",1920,"2010",0,"mathematical analysis","mathematician","AUS",90
"Carl Wilhelm Borchardt",1810,"1880",0,"Q3968","mathematician","COL",70
"Christian Heinrich von Nagel",1800,"1882",0,"geometry","mathematician","DEU",82
"Ernst Leonard Lindelöf",1870,"1946",0,"topology","mathematician","FIN",76
"Shiing-Shen Chern",1910,"2004",1,"differential geometry","mathematician","CHN",94
"Alexis Clairaut",1710,"1765",1,"mathematics","astronomer","CAN",55
"David Francis Barrow",1880,"1970",0,"geometry","mathematician","GRC",90
"Edward Norton Lorenz",1910,"2008",1,"mathematics","mathematician","USA",98
"Raymond Louis Wilder",1890,"1982",1,"topology","mathematician","AUS",92
"Friedrich Robert Helmert",1840,"1917",0,"geodesy","mathematician","AUT",77
"Arthur Herbert Copeland",1890,"1970",1,"probability theory","mathematician","AUS",80
"John L. Kelley",1910,"1999",0,"topology","mathematician","USA",89
"Emil Artin",1890,"1962",1,"Q3968","mathematician","AUT",72
"Ðuro Kurepa",1900,"1993",1,"mathematics","mathematician","HRV",93
"Ruth Moufang",1900,"1977",0,"Q3968","mathematician","DEU",77
"Marston Morse",1890,"1977",1,"topology","mathematician","CAN",87
"James Cullen (mathematician)",1860,"1933",0,"number theory","mathematician","IRL",73
"Sofya Yanovskaya",1890,"1966",1,"Metamathematics","mathematician","BLR",76
"Jakob Steiner",1790,"1863",0,"geometry","mathematician","CHE",73
"George F C Griss",1890,"1953",0,"mathematical analysis","mathematician","COL",63
"Donald Dines Wall",1920,"2000",0,"number theory","mathematician","NIC",80
"William Stanley Jevons",1830,"1882",1,"economics","philosopher","AUS",52
"Thomas M. Cover",1930,"2012",1,"probability theory","mathematician","ARG",82
"José Celestino Mutis",1730,"1808",0,"botany","mathematician","COL",78
"Nathaniel Bowditch",1770,"1838",0,"mathematics","mathematician","DEU",68
"Tom M. Apostol",1920,"2016",0,"number theory","mathematician","USA",96
"Edmund Landau",1870,"1938",0,"number theory","mathematician","COL",68
"Édouard Goursat",1850,"1936",1,"mathematical analysis","mathematician","FRA",86
"Ivan Pervushin",1820,"1900",0,"number theory","mathematician","RUS",80
"Lipman Bers",1910,"1993",1,"mathematics","mathematician","AFG",83
"Richard Arenstorf",1920,"2014",0,"number theory","mathematician","DEU",94
"Tullio Levi-Civita",1870,"1941",0,"differential geometry","mathematician","BGD",71
"Aleksandr Gennadievich Kurosh",1900,"1971",1,"group theory","mathematician","RUS",71
"Frank Adams",1930,"1989",1,"topology","mathematician","AUS",59
"Jean-Victor Poncelet",1780,"1867",1,"mathematics","mathematician","AUS",87
"James Whitbread Lee Glaisher",1840,"1928",1,"number theory","mathematician","BRB",88
"Rusinš Martinš Freivalds",1940,"2016",1,"mathematics","mathematician","LVA",76
"Paul Dirac",1900,"1984",1,"theoretical physics","mathematician","CAN",84
"Marcel Brillouin",1850,"1948",1,"physicist","mathematician","BEL",98
"Erasmus Reinhold",1510,"1553",0,"astronomy","mathematician","DEU",43
"Klaus Wagner",1910,"2000",0,"graph theory","mathematician","BRA",90
"Christopher Zeeman",1920,"2016",1,"topology","mathematician","IDN",96
"Julian Sochocki",1840,"1927",0,"number theory","mathematician","JAM",87
"Joachim Lambek",1920,"2014",0,"Q3968","mathematician","DEU",94
"Daniel Gorenstein",1920,"1992",1,"group theory","mathematician","BOL",72
"Greg Hjorth",1960,"2011",1,"mathematical logic","mathematician","AUS",51
"Nicolaas Govert de Bruijn",1910,"2012",0,"combinatorics","mathematician","NLD",102
"Kunihiko Kodaira",1910,"1997",1,"algebraic geometry","mathematician","JPN",87
"Andrey Markov, Jr.",1900,"1979",1,"mathematical logic","mathematician","RUS",79
"Henri Lebesgue",1870,"1941",1,"mathematical analysis","mathematician","FRA",71
"Antonio Maria Bordoni",1780,"1860",0,"mathematical analysis","mathematician","ITA",80
"Hidehiko Yamabe",1920,"1960",0,"differential geometry","mathematician","JPN",40
"George Uhlenbeck",1900,"1988",1,"theoretical physics","physicist","IDN",88
"Marcel Grossmann",1870,"1936",0,"geometry","mathematician","HUN",66
"Jon Barwise",1940,"2000",1,"mathematical logic","mathematician","BLZ",60
"Horace Lamb",1840,"1934",1,"mathematics","mathematician","AUS",94
"Jean Baptiste Meusnier",1750,"1793",1,"mathematics","mathematician","FRA",43
"Vyacheslav Stepanov",1880,"1950",1,"Function theory","mathematician","RUS",70
"Jack Silver",1940,"2016",0,"set theory","mathematician","USA",76
"Alberto Calderón",1920,"1998",1,"partial differential equation","mathematician","ARG",78
"Abduhamid Juraev",1930,"2005",1,"differential equation","mathematician","TJK",75
"Konrad Knopp",1880,"1957",0,"mathematical analysis","mathematician","COL",77
"Evangelista Torricelli",1600,"1647",0,"physics","mathematician","ITA",47
"Hermann Grassmann",1800,"1877",0,"Q3968","mathematician","POL",77
"Werner Fenchel",1900,"1988",0,"differential geometry","mathematician","COL",88
"Ronald Ross",1850,"1932",1,"malaria","physician","ESP",82
"Radhanath Sikdar",1810,"1870",0,"mathematics","mathematician","IND",60
"Ralph Fox",1910,"1973",1,"topology","mathematician","USA",63
"Giacinto Morera",1850,"1909",0,"mathematical analysis","mathematician","ITA",59
"J. V. Uspensky",1880,"1947",0,"probability theory","mathematician","MNG",67
"Nikolai Efimov",1910,"1982",1,"differential geometry","mathematician","RUS",72
"David Blackwell",1910,"2010",1,"probability theory","mathematician","CAN",100
"Donald G. Higman",1920,"2006",0,"group theory","mathematician","CAN",86
"Francesco Severi",1870,"1961",0,"algebraic geometry","mathematician","HRV",91
"Élie Cartan",1860,"1951",1,"differential geometry","mathematician","FRA",91
"Alexander Kronrod",1920,"1986",1,"Function theory","mathematician","RUS",66
"Arthur Prior",1910,"1969",0,"mathematical logic","mathematician","NZL",59
"Maryam Mirzakhani",1970,"2017",1,"geometry","mathematician","IRN",47
"Evgenii Landis",1920,"1997",1,"differential calculus","mathematician","UKR",77
"Raymond Paley",1900,"1933",0,"mathematical analysis","mathematician","GBR",33
"Helge von Koch",1870,"1924",0,"number theory","mathematician","SWE",54
"Nathan Jacobson",1910,"1999",1,"Q3968","mathematician","JAM",89
"Tibor Gallai",1910,"1992",1,"combinatorics","mathematician","HUN",82
"Roger Apéry",1910,"1994",1,"number theory","mathematician","BRB",84
"Ludolph van Ceulen",1540,"1610",0,"mathematics","mathematician","DEU",70
"Leonid Kantorovich",1910,"1986",1,"functional analysis","mathematician","RUS",76
"Nikolai Nikolaevich Yanenko",1920,"1984",1,"geometry","mathematician","ARM",64
"Johannes Acronius Frisius",1520,"1564",0,"medicine","mathematician","NLD",44
"Christoph Gudermann",1790,"1852",0,"mathematics","mathematician","DEU",62
"John Pell",1610,"1685",0,"number theory","mathematician","GBR",75
"Rafael Bombelli",1520,"1573",0,"Q3968","mathematician","ITA",53
"Vladimir Andreevich Yakubovich",1920,"2012",1,"control theory","mathematician","RUS",92
"Richard Stone",1910,"1991",1,"economics","economist","BLZ",81
"Otto Schreier",1900,"1929",0,"group theory","mathematician","AUT",29
"Kurt Gödel",1900,"1978",1,"set theory","mathematician","CZE",78
"Kazimierz Ajdukiewicz",1890,"1963",0,"logic","philosopher","UKR",73
"Claude Gaspard Bachet de Méziriac",1580,"1638",0,"number theory","mathematician","FRA",58
"Egon Pearson",1890,"1980",1,"statistics","mathematician","GBR",90
"Johan de Witt",1620,"1672",0,"mathematical analysis","mathematician","NLD",52
"Leonard Gillman",1910,"2009",1,"set theory","mathematician","AUS",99
"Ivan Vsevolodovich Meshcherskiy",1850,"1935",1,"mechanics","mathematician","RUS",85
"Mihailo Petrovic",1860,"1943",0,"mathematics","mathematician","BEL",83
"Robert P. Dilworth",1910,"1993",0,"lattice","mathematician","USA",83
"Nikolai Nikolayevich Vorobyov (mathematician)",1920,"1995",0,"algebraic topology","mathematician","RUS",75
"Serge Lang",1920,"2005",1,"number theory","mathematician","FRA",85
"Konstantin Andreev",1840,"1921",0,"geometry","mathematician","RUS",81
"Edwin Spanier",1920,"1996",1,"topology","mathematician","AUS",76
"Ernst Kolman",1890,"1979",0,"mathematics","educator","CZE",89
"Sergei Fomin",1910,"1975",0,"abstract algebra","mathematician","RUS",65
"Edward Nelson",1930,"2014",0,"set theory","mathematician","USA",84
"Charles Hermite",1820,"1901",1,"Q3968","mathematician","FRA",81
"Anatolii Goldberg",1930,"2008",0,"mathematical analysis","mathematician","RUS",78
"Nikolai Kochin",1900,"1944",0,"mathematics","mathematician","RUS",44
"Ernst Specker",1920,"2011",0,"set theory","mathematician","CHE",91
"Andreas Floer",1950,"1991",0,"topology","mathematician","BEL",41
"Wilhelm Blaschke",1880,"1962",1,"differential geometry","mathematician","AUT",82
"Ernst Zermelo",1870,"1953",1,"mathematical logic","mathematician","COL",83
"Benjamin Peirce",1800,"1880",0,"Q3968","mathematician","DEU",80
"Wilhelm Wirtinger",1860,"1945",0,"mathematics","mathematician","AUT",85
"Jakob Hermann",1670,"1733",0,"mechanics","mathematician","BEL",63
"György Elekes",1940,"2008",0,"combinatorics","mathematician","HUN",68
"Francesco Maria Grimaldi",1610,"1663",0,"physicist","physicist","ITA",53
"Deane Montgomery",1900,"1992",1,"topology","mathematician","USA",92
"Boris Moishezon",1930,"1993",1,"algebraic geometry","mathematician","UKR",63
"Pierre-Simon Laplace",1740,"1827",1,"celestial mechanics","mathematician","FRA",87
"Georgiy Shilov",1910,"1975",1,"Function theory","mathematician","BGR",65
"Joseph Diaz Gergonne",1770,"1859",0,"geometry","mathematician","BOL",89
"John R. Stallings",1930,"2008",1,"group theory","mathematician","USA",78
"Oleg Lupanov",1930,"2006",1,"discrete mathematics","mathematician","RUS",76
"Nikolai Smirnov (mathematician)",1900,"1966",1,"probability theory","mathematician","RUS",66
"Harry Rauch",1920,"1979",0,"differential geometry","mathematician","CAN",59
"Poul Heegaard",1870,"1948",0,"topology","mathematician","DNK",78
"Boris Delaunay",1890,"1980",1,"abstract algebra","mathematician","RUS",90
"Joseph Wolstenholme",1820,"1891",0,"number theory","mathematician","FRA",71
"Oskar Anderson",1880,"1960",0,"mathematics","mathematician","BLR",80
"Georgy Adelson-Velsky",1920,"2014",0,"mathematics","mathematician","ETH",94
"Ivan Ivanovich Zhegalkin",1860,"1947",1,"mathematical logic","mathematician","RUS",87
"Émile Borel",1870,"1956",1,"probability theory","mathematician","FRA",86
"Marina Ratner",1930,"2017",1,"mathematics","mathematician","RUS",87
"Carl Friedrich Gauss",1770,"1855",1,"number theory","mathematician","AUS",85
"Bertrand Russell",1870,"1970",1,"set theory","mathematician","GBR",100
"Clive Granger",1930,"2009",1,"economics","economist","AUS",79
"Nikolai Luzin",1880,"1950",1,"Function theory","mathematician","RUS",70
"Christian Wiener",1820,"1896",0,"geometry","mathematician","DEU",76
"René-Louis Baire",1870,"1932",0,"topology","mathematician","CAN",62
"Victor Andreevich Toponogov",1930,"2004",0,"geometry","mathematician","RUS",74
"William Wallace (mathematician)",1760,"1843",0,"geometry","mathematician","AUS",83
"Jacob Wolfowitz",1910,"1981",1,"probability theory","mathematician","USA",71
"Carl Adam Petri",1920,"2010",1,"mathematics","mathematician","DEU",90
"Herman Wold",1900,"1992",0,"probability theory","mathematician","NOR",92
"Jacques Philippe Marie Binet",1780,"1856",0,"astronomy","mathematician","FRA",76
"René de Saussure",1860,"1943",0,"mathematics","mathematician","CHE",83
"Vincenzo Riccati",1700,"1775",0,"mathematics","mathematician","ITA",75
"David George Kendall",1910,"2007",1,"probability theory","mathematician","CAN",97
"Nikolai Aleksandrovich Shanin",1910,"2011",0,"topology","mathematician","RUS",101
"László Kalmár",1900,"1976",1,"mathematical logic","mathematician","HUN",76
"Eugene Lukacs",1900,"1987",0,"probability theory","mathematician","HUN",87
"Richard Friederich Arens",1910,"2000",0,"mathematical analysis","mathematician","DEU",90
"Edwin E. Moise",1910,"1998",1,"geometry","mathematician","BRB",88
"Martin Eichler",1910,"1992",0,"number theory","mathematician","DEU",82
"George Piranian",1910,"2009",0,"mathematical analysis","mathematician","CHE",99
"Max Dehn",1870,"1952",0,"group theory","mathematician","DEU",82
"Andrew M. Gleason",1920,"2008",0,"mathematical analysis","mathematician","COL",88
"John Forbes Nash Jr.",1920,"2015",1,"partial differential equation","mathematician","USA",95
"Renato Caccioppoli",1900,"1959",0,"mathematical analysis","mathematician","ITA",59
"Klaus Matthes",1930,"1998",1,"probability theory","mathematician","COL",68
"Piers Bohl",1860,"1921",0,"mathematical analysis","mathematician","BEL",61
"Waclaw Sierpinski",1880,"1969",1,"number theory","mathematician","JAM",89
"Martin Löb",1920,"2006",0,"mathematical logic","mathematician","COL",86
"Hans Carl Friedrich von Mangoldt",1850,"1925",0,"number theory","mathematician","DEU",75
"Benoit Mandelbrot",1920,"2010",1,"fractal","mathematician","JAM",90
"Vladimir Smirnov (mathematician)",1880,"1974",1,"complex analysis","mathematician","RUS",94
"Gaspard Monge",1740,"1818",1,"differential geometry","mathematician","FRA",78
"Stanislaw Zaremba (mathematician)",1860,"1942",0,"mathematical analysis","mathematician","UKR",82
"Élisabeth Lutz",1910,"2008",0,"number theory","mathematician","AUT",98
"Alexander Oppenheim",1900,"1997",1,"number theory","mathematician","GBR",97
"Ludwig Burmester",1840,"1927",0,"geometry","mathematician","DEU",87
"Siméon Denis Poisson",1780,"1840",1,"mathematical analysis","mathematician","FRA",60
"Johann Jakob Balmer",1820,"1898",0,"mathematics","physicist","CHE",78
"Wu Wenjun",1910,"2017",1,"topology","mathematician","CHN",107
"Wilhelm Launhardt",1830,"1918",0,"mathematics","mathematician","CAN",88
"Charles Jean de la Vallée-Poussin",1860,"1962",1,"number theory","mathematician","BEL",102
"Giacomo F. Maraldi",1660,"1729",0,"astronomy","astronomer","ITA",69
"Gerhard Hessenberg",1870,"1925",0,"geometry","mathematician","DEU",55
"Viacheslav Belavkin",1940,"2012",0,"applied mathematics","mathematician","UKR",72
"Peter Hilton",1920,"2010",0,"topology","mathematician","BLZ",90
"Srinivasa Ramanujan",1880,"1920",1,"combinatorics","mathematician","IND",40
"Aleksandr Nekrasov",1880,"1957",1,"functional analysis","mathematician","RUS",77
"Atle Selberg",1910,"2007",1,"number theory","mathematician","NOR",97
"Farkas Bolyai",1770,"1856",0,"mathematics","mathematician","ERI",86
"Miron Nicolescu",1900,"1975",0,"mathematics","mathematician","ROU",75
"Roland Dobrushin",1920,"1995",0,"probability theory","mathematician","RUS",75
"Nesmith Ankeny",1920,"1993",0,"number theory","mathematician","AUS",73
"Boris Yakovlevich Bukreev",1850,"1962",1,"differential equation","mathematician","RUS",112
"Leonid Khachiyan",1950,"2005",1,"applied mathematics","mathematician","RUS",55
"Adolph P. Yushkevich",1900,"1993",1,"history of mathematics","mathematician","UKR",93
"Herbert A. Simon",1910,"2001",1,"economics","economist","USA",91
"Alexander Abrosimov",1940,"2011",0,"complex analysis","mathematician","ETH",71
"Giovanni Antonio Magini",1550,"1617",0,"cartography","astronomer","BGD",67
"William George Horner",1780,"1837",0,"mathematics","mathematician","CAN",57
"Garrett Birkhoff",1910,"1996",1,"Q3968","mathematician","CAN",86
"Allyn Abbott Young",1870,"1929",0,"economics","economist","GBR",59
"Henry Mann",1900,"2000",1,"group theory","mathematician","AUT",100
"Lorenzo Respighi",1820,"1889",0,"astronomy","mathematician","ITA",69
"Reinhold Baer",1900,"1979",0,"Q3968","mathematician","COL",79
"Duncan Sommerville",1870,"1934",1,"geometry","mathematician","IND",64
"Heini Halberstam",1920,"2014",0,"number theory","mathematician","BEL",94
"Armand Borel",1920,"2003",1,"topology","mathematician","CHE",83
"Augustin-Louis Cauchy",1770,"1857",1,"mathematical analysis","mathematician","CAN",87
"Karl Prachar",1920,"1994",0,"number theory","mathematician","AUT",74
"Yasuaki Aida",1740,"1817",0,"geometry","mathematician","JPN",77
"Julius Weisbach",1800,"1871",0,"hydraulics","mathematician","DEU",71
"Naum Meiman",1910,"2001",1,"physics","mathematician","BLR",91
"Paul Émile Appell",1850,"1930",1,"mathematical analysis","mathematician","BEL",80
"Viktor Vladimirovich Nemytskii",1900,"1967",1,"differential equation","mathematician","RUS",67
"Manohar Vartak",1920,"1997",0,"combinatorics","mathematician","IND",77
"John William Theodore Youngs",1910,"1970",1,"graph theory","mathematician","BGD",60
"Andrey Markov",1850,"1922",1,"probability theory","mathematician","RUS",72
"Ronald Fisher",1890,"1962",1,"statistics","mathematician","BLZ",72
"Alfred Korzybski",1870,"1950",0,"engineering","mathematician","JAM",80
"Ernst G. Straus",1920,"1983",0,"combinatorics","mathematician","DEU",63
"Luigi Bodio",1840,"1920",0,"statistics","economist","AFG",80
"George Pólya",1880,"1985",0,"mathematical analysis","mathematician","HUN",105
"Enrico Betti",1820,"1892",0,"topology","mathematician","ITA",72
"Richard Dedekind",1830,"1916",0,"Q3968","mathematician","AUS",86
"Vyacheslav Vasilievich Sazonov",1930,"2002",1,"probability theory","mathematician","RUS",72
"Ludwig Berwald",1880,"1942",0,"differential geometry","mathematician","CZE",62
"Karl Menger",1900,"1985",1,"mathematics","mathematician","AUT",85
"Evgenii Georgievich Dyakonov",1930,"2006",1,"mathematical physics","mathematician","RUS",76
"Robin Gandy",1910,"1995",0,"mathematical logic","mathematician","GBR",85
"Leonard Jimmie Savage",1910,"1971",1,"mathematics","mathematician","USA",61
"Kurt Mahler",1900,"1988",1,"mathematical analysis","mathematician","DEU",88
"Vladimir Markovich Entov",1930,"2008",0,"applied mathematics","mathematician","RUS",78
"Tommaso Boggio",1870,"1963",0,"mathematical analysis","mathematician","ITA",93
"Isidor Natanson",1900,"1964",0,"mathematical analysis","mathematician","CHE",64
"Daihachiro Sato",1930,"2008",0,"number theory","mathematician","JPN",78
"János Bolyai",1800,"1860",0,"geometry","mathematician","ROU",60
"William Thurston",1940,"2012",1,"topology","mathematician","ARG",72
"Vasili Yakovlevich Zinger",1830,"1907",0,"mathematics","philosopher","RUS",77
"Richard Courant",1880,"1972",1,"mathematical analysis","mathematician","POL",92
"Alberto González Domínguez",1900,"1982",1,"mathematical analysis","mathematician","ARG",82
"Allan Joseph Champneys Cunningham",1840,"1928",0,"number theory","mathematician","CAN",88
"Mario Pieri",1860,"1913",0,"geometry","mathematician","ITA",53
"Fokko du Cloux",1950,"2006",0,"computer science","mathematician","DEU",56
"Ralph P. Boas Jr.",1910,"1992",1,"mathematical analysis","mathematician","AUS",82
"Reinhold Strassmann",1890,"1944",0,"number theory","mathematician","COL",54
"Robert Woodhouse",1770,"1827",1,"mathematical analysis","mathematician","CAN",57
"John Hasbrouck Van Vleck",1890,"1980",1,"physics","mathematician","AUS",90
"Samuel Karlin",1920,"2007",1,"functional analysis","mathematician","USA",87
"Hendrik Kloosterman",1900,"1968",0,"number theory","mathematician","NLD",68
"Daniel Shanks",1910,"1996",0,"number theory","mathematician","BLZ",86
"Alfréd Rényi",1920,"1970",1,"probability theory","mathematician","HUN",50
"Pierre Fatou",1870,"1929",1,"Complex dynamics","mathematician","FRA",59
"Jean le Rond dAlembert",1710,"1783",1,"mathematics","philosopher","CAN",73
"Blaise Pascal",1620,"1662",0,"probability theory","mathematician","FRA",42
"Ivan Petrovsky",1900,"1973",1,"partial differential equation","mathematician","RUS",73
"Basil Gordon",1930,"2012",0,"combinatorics","mathematician","COL",82
"Jurij Vega",1750,"1802",0,"computational mathematics","mathematician","SVN",52
"Jacques Hadamard",1860,"1963",1,"partial differential equation","mathematician","ARG",103
"Vladimir Arnold",1930,"2010",1,"mathematical analysis","mathematician","UKR",80
"Felix Gantmacher",1900,"1964",1,"mathematical analysis","mathematician","UKR",64
"Georges Reeb",1920,"1993",0,"mathematics","mathematician","FRA",73
"Galileo Galilei",1560,"1642",0,"astronomy","astronomer","COL",82
"Thomas Fincke",1560,"1656",0,"trigonometry","mathematician","DEU",96
"Cesare Arzelà",1840,"1912",0,"mathematical analysis","mathematician","ITA",72
"Pelageya Polubarinova-Kochina",1890,"1999",1,"mechanics","mathematician","KAZ",109
"Eugenio Giuseppe Togliatti",1890,"1977",0,"mathematics","mathematician","ITA",87
"Dmitrii Menshov",1890,"1988",1,"mathematical analysis","mathematician","RUS",98
"Aleksandr Kotelnikov",1860,"1944",1,"projective geometry","mathematician","AFG",84
"David A. Huffman",1920,"1999",1,"information theory","computer scientist","AUS",79
"Paul Lévy (mathematician)",1880,"1971",1,"probability theory","mathematician","CAN",91
"Friedrich Hirzebruch",1920,"2012",1,"mathematics","mathematician","DEU",92
"Anatoliy Skorokhod",1930,"2011",1,"probability theory","mathematician","BGR",81
"W. R. (Red) Alford",1930,"2003",0,"number theory","mathematician","CHN",73
"Hermann Minkowski",1860,"1909",1,"geometry","physicist","LTU",49
"Nigel Kalton",1940,"2010",0,"functional analysis","mathematician","AUS",70
"Edwin Hewitt",1920,"1999",1,"mathematical analysis","mathematician","USA",79
"Paul Lorenzen",1910,"1994",1,"proof theory","mathematician","BEL",84
"Fritz John",1910,"1994",1,"mathematical analysis","mathematician","COL",84
"Israel Nathan Herstein",1920,"1988",1,"Q3968","mathematician","POL",68
"Hermann Rothe",1880,"1923",0,"group theory","mathematician","AUT",43
"Herbert Busemann",1900,"1994",0,"differential geometry","mathematician","COL",94
"Harry Bateman",1880,"1946",1,"mathematics","mathematician","BOL",66
"Robert Giffen",1830,"1910",1,"statistics","economist","GBR",80
"Ernst Schröder",1840,"1902",0,"mathematics","mathematician","DEU",62
"Paul A. Catlin",1940,"1995",0,"graph theory","mathematician","CAN",55
"Carlo Emilio Bonferroni",1890,"1960",0,"probability theory","mathematician","ITA",70
"Charles Spearman",1860,"1945",1,"psychology","psychologist","BLZ",85
"Martin Gardner",1910,"2010",0,"mathematics","mathematician","PAK",100
"Hans Zassenhaus",1910,"1991",0,"group theory","mathematician","CHE",81
"Nikolay Mitrofanovich Krylov",1870,"1955",1,"mechanics","mathematician","RUS",85
"Federico Commandino",1500,"1575",0,"mathematics","mathematician","ITA",75
"Zdenek Frolík",1930,"1989",0,"topology","mathematician","CZE",59
"Detlef Gromoll",1930,"2008",0,"differential geometry","mathematician","COL",78
"Gabriel Mouton",1610,"1694",0,"mathematics","priest","ATG",84
"Eric Harold Neville",1880,"1961",0,"mathematics","mathematician","BLZ",81
"Traian Lalescu",1880,"1929",0,"mathematical analysis","mathematician","ROU",49
"Pietro Mengoli",1620,"1686",0,"mathematics","mathematician","ITA",66
"William Feller",1900,"1970",1,"probability theory","mathematician","BIH",70
"Nikoloz Muskhelishvili",1890,"1976",1,"integral equation","mathematician","GEO",86
"Mary Celine Fasenmyer",1900,"1996",0,"mathematical analysis","mathematician","USA",96
"François Arago",1780,"1853",1,"physics","astronomer","FRA",73
"Gordon Welchman",1900,"1985",0,"mathematics","mathematician","CAN",85
"Johannes van der Corput",1890,"1975",0,"number theory","mathematician","NLD",85
"Jean-Christophe Yoccoz",1950,"2016",1,"mathematics","mathematician","CAN",66
"Louis Bachelier",1870,"1946",0,"probability theory","mathematician","CAN",76
"E. M. Wright",1900,"2005",0,"number theory","mathematician","GBR",105
"Vyacheslav Ivanovich Lebedev",1930,"2010",1,"computational mathematics","mathematician","RUS",80
"Theodor Vahlen",1860,"1945",0,"number theory","mathematician","AUT",85
"Heinrich Franz Friedrich Tietze",1880,"1964",1,"group theory","mathematician","AUT",84
"Henry Thomas Colebrooke",1760,"1837",1,"Sanskrit","botanist","BLZ",77
"Colin Maclaurin",1690,"1746",1,"mathematics","mathematician","BLZ",56
"Alfred Brauer",1890,"1985",0,"number theory","mathematician","DEU",95
"Gösta Mittag-Leffler",1840,"1927",0,"mathematics","mathematician","SWE",87
"W. V. D. Hodge",1900,"1975",1,"mathematics","mathematician","GBR",75
"Mark Vishik",1920,"2012",0,"differential equation","mathematician","UKR",92
"James Hopwood Jeans",1870,"1946",1,"physics","mathematician","GBR",76
"Satyendra Nath Bose",1890,"1974",1,"mathematical physics","physicist","IND",84
"Dmitri Anosov",1930,"2014",1,"differential equation","mathematician","RUS",84
"Willem de Sitter",1870,"1934",1,"astronomy","astronomer","NLD",64
"Ismaël Bullialdus",1600,"1694",1,"astronomy","astronomer","CHN",94
"Ellice Horsburgh",1870,"1935",1,"numismatics","mathematician","AUS",65
"François Thureau-Dangin",1870,"1944",0,"Oriental studies","anthropologist","CAN",74
"Rajeev Motwani",1960,"2009",1,"informatics","mathematician","IND",49
"Pierre Raymond de Montmort",1670,"1719",1,"mathematics","mathematician","CAN",49
"Akif Jafar Hajiyev",1930,"2015",0,"mathematical analysis","mathematician","AZE",85
"Monroe D. Donsker",1920,"1991",0,"probability theory","mathematician","AUS",71
"Edwin Thompson Jaynes",1920,"1998",0,"statistical physics","physicist","AUS",78
"John Alan Robinson",1930,"2016",1,"mathematics","mathematician","BRB",86
"Gabriel Lamé",1790,"1870",1,"mathematics","mathematician","FRA",80
"Philip Hall",1900,"1982",1,"Q3968","mathematician","GBR",82
"Peter Ludwig Mejdell Sylow",1830,"1918",1,"group theory","mathematician","DNK",88
"Pierre Wantzel",1810,"1848",0,"geometry","mathematician","CAN",38
"Nicolaus I Bernoulli",1680,"1759",1,"probability theory","mathematician","BEL",79
"Denis Sargan",1920,"1996",0,"economics","economist","AUS",76
"Vadim Yefremovich",1900,"1989",0,"mathematical analysis","mathematician","UKR",89
"Ludwig Stickelberger",1850,"1936",0,"number theory","mathematician","AFG",86
"George Green (mathematician)",1790,"1841",0,"mathematical analysis","mathematician","CAN",51
"Derrick Henry Lehmer",1900,"1991",1,"number theory","mathematician","AUS",91
"Federico Cafiero",1910,"1980",0,"mathematical analysis","mathematician","ITA",70
"Emilio Bajada",1910,"1984",0,"mathematical analysis","mathematician","EGY",74
"Paul Gustav Heinrich Bachmann",1830,"1920",0,"group theory","mathematician","COL",90
"Henri Brocard",1840,"1922",1,"geometry","mathematician","FRA",82
"Alfred Horn",1910,"2001",0,"lattice","mathematician","USA",91
"Arthur Byron Coble",1870,"1966",0,"group theory","mathematician","AUS",96
"Olga Ladyzhenskaya",1920,"2004",1,"mathematical analysis","mathematician","RUS",84
"Heiner Zieschang",1930,"2004",1,"topology","mathematician","BEL",74
"Joseph Liouville",1800,"1882",1,"mathematical analysis","mathematician","FRA",82
"Joseph L. Doob",1910,"2004",1,"probability theory","mathematician","COL",94
"Vitold Shmulyan",1910,"1944",0,"functional analysis","mathematician","KAZ",34
"Johann Benedict Listing",1800,"1882",0,"topology","mathematician","DEU",82
"Alexander Friedmann",1880,"1925",1,"theoretical physics","mathematician","RUS",45
"Vladimir Andrunakievich",1910,"1997",1,"Q3968","mathematician","RUS",87
"Andrzej Grzegorczyk",1920,"2014",0,"mathematical logic","mathematician","JAM",94
"Nicolas Léonard Sadi Carnot",1790,"1832",0,"thermodynamics","mathematician","CAN",42
"Lorenzo Mascheroni",1750,"1800",0,"geometry","mathematician","ITA",50
"Vitalii Ditkin",1910,"1987",1,"computational mathematics","mathematician","RUS",77
"Arnold S. Shapiro",1920,"1962",0,"topology","mathematician","BOL",42
"Paul Epstein",1870,"1939",0,"number theory","mathematician","DEU",69
"Sylvestre François Lacroix",1760,"1843",0,"mathematics","mathematician","CAN",83
"Brook Taylor",1680,"1731",1,"mathematical analysis","mathematician","AUS",51
"Aizik Volpert",1920,"2006",0,"mathematical analysis","mathematician","UKR",86
"Anatoly Maltsev",1900,"1967",1,"model theory","mathematician","RUS",67
"Erika Pannwitz",1900,"1975",0,"topology","mathematician","DEU",75
"Alexander Ostrowski",1890,"1986",0,"Q3968","mathematician","RUS",96
"Michel Deza",1930,"2016",0,"combinatorics","mathematician","RUS",86
"Baha<U+02BE> al-din al-<U+02BF>Amili",1540,"1622",0,"mathematician","mathematician","LBN",82
"Raphael M. Robinson",1910,"1995",0,"set theory","mathematician","USA",85
"Étienne Bézout",1730,"1783",0,"number theory","mathematician","DZA",53
"Ennio de Giorgi",1920,"1996",0,"mathematical analysis","mathematician","ITA",76
"Stephen Cole Kleene",1900,"1994",1,"theoretical computer science","mathematician","GBR",94
"Leonard Eugene Dickson",1870,"1954",1,"Q3968","mathematician","PNG",84
"Jean-Jacques Moreau",1920,"2014",0,"mathematics","mathematician","FRA",94
"Hanna Neumann",1910,"1971",0,"group theory","mathematician","COL",61
"Caspar Wessel",1740,"1818",0,"mathematics","mathematician","NOR",78
"Richard Lashof",1920,"2010",0,"topology","mathematician","BRA",90
"Paolo Ruffini",1760,"1822",0,"Q3968","mathematician","ITA",62
"Andrei Petrovich Kiselyov",1850,"1940",1,"mathematical analysis","mathematician","RUS",90
"Jurjen Ferdinand Koksma",1900,"1964",0,"number theory","mathematician","NLD",64
"Hermann Hankel",1830,"1873",0,"mathematical analysis","mathematician","BEL",43
"Sarvadaman Chowla",1900,"1995",1,"number theory","mathematician","BLZ",95
"Paul-André Meyer",1930,"2003",1,"probability theory","mathematician","FRA",73
"Alexander Gelfond",1900,"1968",1,"number theory","mathematician","RUS",68
"James Clerk Maxwell",1830,"1879",1,"physics","physicist","GBR",49
"Ruan Yuan",1760,"1849",0,"chinese philosophy","mathematician","CHN",89
"Jerzy Neyman",1890,"1981",1,"mathematical analysis","mathematician","IDN",91
"Camille Jordan",1830,"1922",1,"group theory","mathematician","ATG",92
"Abraham Adrian Albert",1900,"1972",1,"Q3968","mathematician","BLZ",72
"Tatyana Afanasyeva",1870,"1964",0,"probability theory","mathematician","RUS",94
"Carl Ludwig Siegel",1890,"1981",1,"number theory","mathematician","COL",91
"Paul Finsler",1890,"1970",0,"differential geometry","mathematician","DEU",80
"Józef Maria Hoene-Wronski",1770,"1853",0,"mathematics","mathematician","POL",83
"Niels Henrik Abel",1800,"1829",1,"group theory","mathematician","NOR",29
"Kiyosi Itô",1910,"2008",1,"probability theory","mathematician","JPN",98
"Ernesto Cesàro",1850,"1906",0,"differential geometry","mathematician","ITA",56
"Mary Ellen Rudin",1920,"2013",0,"topology","mathematician","USA",93
"Graham Higman",1910,"2008",1,"group theory","mathematician","AUS",98
"Kiiti Morita",1910,"1995",0,"Q3968","mathematician","JPN",85
"András Hajnal",1930,"2016",0,"combinatorics","mathematician","HUN",86
"Jagdish Chandra Bose",1850,"1937",1,"physics","quantum physicist","IND",87
"George Ballard Mathews",1860,"1922",1,"number theory","mathematician","GBR",62
"Gerard Laman",1920,"2009",0,"mathematics","mathematician","NLD",89
"Antoni Zygmund",1900,"1992",1,"mathematical analysis","mathematician","JAM",92
"Girard Desargues",1590,"1661",0,"geometry","mathematician","ATG",71
"Juliusz Schauder",1890,"1943",0,"partial differential equation","mathematician","UKR",53
"Erhard Schmidt",1870,"1959",1,"functional analysis","mathematician","EST",89
"Ferdinand Georg Frobenius",1840,"1917",0,"Q3968","mathematician","DEU",77
"Horst Schubert",1910,"2001",0,"topology","mathematician","DEU",91
"Joseph Bertrand",1820,"1900",1,"probability theory","mathematician","CAN",80
"Ferdinand Minding",1800,"1885",1,"differential geometry","mathematician","POL",85
"Richard Brauer",1900,"1977",1,"group theory","mathematician","DEU",77
"Patrick Suppes",1920,"2014",1,"set theory","mathematician","PAK",94
"Fritz Gassmann",1890,"1990",0,"number theory","mathematician","CHE",100
"Théophile Pépin",1820,"1904",0,"number theory","mathematician","FRA",84
"José Luis Massera",1910,"2002",1,"mathematical analysis","mathematician","AUS",92
"Gotthold Eisenstein",1820,"1852",0,"number theory","mathematician","COL",32
"Ernest Barnes",1870,"1953",1,"mathematics","mathematician","GBR",83
"Karl F. Sundman",1870,"1949",0,"mathematics","mathematician","FIN",79
"André Weil",1900,"1998",1,"algebraic geometry","mathematician","CAN",98
"Hans Heilbronn",1900,"1975",1,"number theory","mathematician","COL",75
"Grigore Moisil",1900,"1973",1,"mathematical logic","mathematician","ROU",73
"Paul Bernays",1880,"1977",0,"mathematical logic","mathematician","BLZ",97
"Alfred Pringsheim",1850,"1941",0,"mathematics","mathematician","LTU",91
"Vito Volterra",1860,"1940",1,"mathematical analysis","mathematician","AUS",80
"Ilya Piatetski-Shapiro",1920,"2009",1,"number theory","mathematician","RUS",89
"Shimon Even",1930,"2004",0,"graph theory","mathematician","ISR",74
"Yuri Prokhorov",1920,"2013",1,"probability theory","mathematician","RUS",93
"Joseph Wedderburn",1880,"1948",1,"Q3968","mathematician","GBR",68
"Nikita Moiseyev",1910,"2000",1,"system analysis","mathematician","RUS",90
"Johann Euler",1730,"1800",1,"mathematics","mathematician","RUS",70
"Karl Wilhelm Feuerbach",1800,"1834",0,"geometry","mathematician","DEU",34
"Boris Koyalovich",1860,"1941",0,"probability theory","mathematician","RUS",81
"Lars Gårding",1910,"2014",0,"partial differential equation","mathematician","SWE",104
"Eugenio Elia Levi",1880,"1917",0,"mathematical analysis","mathematician","BLR",37
"Ada Lovelace",1810,"1852",0,"computer science","mathematician","BLZ",42
"Theodor Molien",1860,"1941",1,"group theory","mathematician","AFG",81
"Pierre Varignon",1650,"1722",1,"mathematical analysis","mathematician","ESP",72
"Yutaka Taniyama",1920,"1958",0,"number theory","mathematician","IND",38
"Robert Edmund Edwards",1920,"2000",0,"functional analysis","mathematician","BLZ",80
"Alexander Anderson (mathematician)",1580,"1620",0,"Q3968","mathematician","ATG",40
"Jakow Trachtenberg",1880,"1953",0,"mathematics","mathematician","UKR",73
"Maxime Bôcher",1860,"1918",0,"mathematical analysis","mathematician","BOL",58
"Abel Transon",1800,"1876",1,"mathematics","mathematician","ARG",76
"Friedrich Bessel",1780,"1846",1,"mathematics","astronomer","AUS",66
"Alfred Young",1870,"1940",1,"combinatorics","mathematician","GBR",70
"Emanuels Grinbergs",1910,"1982",0,"graph theory","mathematician","RUS",72
"Johan Jensen (mathematician)",1850,"1925",0,"number theory","mathematician","DNK",75
"Kenjiro Shoda",1900,"1977",1,"mathematics","mathematician","JPN",77
"Pieter Hendrik Schoute",1840,"1913",0,"geometry","mathematician","NLD",73
"Herman Auerbach",1900,"1942",0,"mathematics","mathematician","UKR",42
"Pavel Alexandrov",1890,"1982",1,"topology","mathematician","RUS",92
"Horst Sachs",1920,"2016",1,"graph theory","mathematician","DEU",96
"Kari Karhunen",1910,"1992",0,"probability theory","mathematician","FIN",82
"Adrien-Marie Legendre",1750,"1833",1,"number theory","mathematician","CAN",83
"Pierre Gabriel",1930,"2015",0,"mathematics","mathematician","FRA",85
"Robert Richard Anstice",1810,"1853",0,"combinatorics","mathematician","GBR",43
"Louis Poinsot",1770,"1859",1,"analytical mechanics","mathematician","AUS",89
"Karl Weissenberg",1890,"1976",1,"rheology","mathematician","AUT",86
"Jovan Karamata",1900,"1967",0,"mathematical analysis","mathematician","BIH",67
"Johannes Fallati",1800,"1855",0,"statistician","economist","DEU",55
"Jacques Herbrand",1900,"1931",0,"proof theory","mathematician","CAN",31
"Robert Fricke",1860,"1930",0,"mathematical analysis","mathematician","DEU",70
"Gabriel Andrew Dirac",1920,"1984",0,"graph theory","mathematician","HUN",64
"Frank Spitzer",1920,"1992",1,"probability theory","mathematician","AUT",72
"Francis Sowerby Macaulay",1860,"1937",1,"algebraic geometry","mathematician","GBR",77
"Jérôme Franel",1850,"1939",0,"number theory","mathematician","CHE",89
"Ervand Kogbetliantz",1880,"1974",0,"mathematics","mathematician","RUS",94
"Agner Krarup Erlang",1870,"1929",0,"queueing theory","mathematician","AUS",59
"Cathleen Synge Morawetz",1920,"2017",1,"mathematical analysis","mathematician","AUS",97
"Kosaku Yosida",1900,"1990",1,"mathematical analysis","mathematician","JPN",90
"Joseph Jean Baptiste Neuberg",1840,"1926",1,"mathematics","mathematician","LUX",86
"Lucio Lombardo-Radice",1910,"1982",0,"combinatorics","mathematician","AGO",72
"Frederick Valentine Atkinson",1910,"2002",0,"mathematical analysis","mathematician","BLZ",92
"Constantin Carathéodory",1870,"1950",0,"mathematical analysis","mathematician","COL",80
"Charles Babbage",1790,"1871",1,"mathematics","mathematician","BLZ",81
"Georges de Rham",1900,"1990",1,"topology","mathematician","CHE",90
"Henry John Stephen Smith",1820,"1883",1,"number theory","mathematician","AUS",63
"Jean-Robert Argand",1760,"1822",0,"complex number","mathematician","CHE",62
"Wilhelm Klingenberg",1920,"2010",0,"differential geometry","mathematician","AUT",90
"Édouard Roche",1820,"1883",1,"astronomy","astronomer","FRA",63
"Nicolas de Malézieu",1650,"1727",0,"Greek studies","mathematician","CAN",77
"Anatoli Georgievich Vitushkin",1930,"2004",1,"approximation theory","mathematician","RUS",74
"Emil Grosswald",1910,"1989",0,"mathematical analysis","mathematician","ROU",79
"H. F. Baker",1860,"1956",1,"partial differential equation","mathematician","AUS",96
"Gaston Tarry",1840,"1913",0,"combinatorics","mathematician","FRA",73
"Dudley E. Littlewood",1900,"1979",0,"group theory","mathematician","BLZ",79
"James Waddell Alexander II",1880,"1971",1,"topology","mathematician","USA",91
"Martin Ohm",1790,"1872",0,"mathematics","mathematician","DEU",82
"Frank Morley",1860,"1937",0,"geometry","mathematician","AUS",77
"Luigi Bianchi",1850,"1928",0,"differential geometry","mathematician","CHN",78
"Frank P. Ramsey",1900,"1930",0,"combinatorics","mathematician","AUS",30
"Paul Matthieu Hermann Laurent",1840,"1908",1,"mathematical analysis","mathematician","LUX",68
"Aleksei Fedorovich Filippov",1920,"2006",1,"theory of differential equations","mathematician","RUS",86
"Jakob Rosanes",1840,"1922",0,"algebraic geometry","mathematician","BLR",82
"Felix Pollaczek",1890,"1981",1,"queueing theory","mathematician","AUT",91
"E. T. Whittaker",1870,"1956",1,"mathematics","mathematician","AUS",86
"E. H. Moore",1860,"1932",0,"algebraic geometry","mathematician","USA",72
"Stanislaw Golab",1900,"1980",0,"geometry","mathematician","AUT",80
"Emanuel Lasker",1860,"1941",1,"Q3968","mathematician","POL",81
"Willebrord Snellius",1580,"1626",0,"mathematics","astronomer","NLD",46
"Paul Olum",1910,"2001",0,"topology","mathematician","USA",91
"Sophus Lie",1840,"1899",1,"group theory","mathematician","NOR",59
"Yevgenii Vasilevich Zolotov",1920,"1990",1,"mathematical model","mathematician","AUS",70
"Bronislaw Knaster",1890,"1980",0,"topology","mathematician","JAM",90
"Jacobus Golius",1590,"1667",0,"Oriental studies","mathematician","NLD",77
"Gordon Thomas Whyburn",1900,"1969",1,"topology","mathematician","USA",69
"Eduard Heine",1820,"1881",0,"mathematical analysis","mathematician","COL",61
"Zoltán Tibor Balogh",1950,"2002",0,"topology","mathematician","HUN",52
"Gerolamo Cardano",1500,"1576",0,"mathematics","philosopher","COL",76
"Albert Ingham",1900,"1967",1,"number theory","mathematician","AUS",67
"Dmitri Egorov",1860,"1931",1,"differential geometry","mathematician","RUS",71
"William Kingdon Clifford",1840,"1879",1,"Q3968","mathematician","AUS",39
"Paul Stäckel",1860,"1919",0,"differential geometry","mathematician","COL",59
"Peter M. Gruber",1940,"2017",1,"geometry","mathematician","AUT",77
"Émile Lemoine",1840,"1912",1,"geometry","mathematician","FRA",72
"Aleksandr Lyapunov",1850,"1918",0,"stability theory","mathematician","RUS",68
"Otto Schilling",1910,"1973",0,"Q3968","mathematician","DEU",63
"Mstislav Keldysh",1910,"1978",1,"mathematics","mathematician","AFG",68
"Lazarus Fuchs",1830,"1902",1,"complex analysis","mathematician","ITA",72
"Karel deLeeuw",1930,"1978",0,"mathematical analysis","mathematician","BLZ",48
"Marian Rejewski",1900,"1980",1,"mathematics","mathematician","POL",80
"Emmy Noether",1880,"1935",1,"Q3968","mathematician","DEU",55
"Edward Bromhead",1780,"1855",0,"mathematical analysis","mathematician","AUS",75
"Peter Tait (physicist)",1830,"1901",1,"mathematical physics","mathematician","AUS",71
"Joseph Liberman",1910,"1941",0,"functional analysis","mathematician","UKR",31
"Olga Tsuberbiller",1880,"1975",0,"mathematics","university teacher","RUS",95
"Lucien Le Cam",1920,"2000",0,"probability theory","mathematician","FRA",80
"Valentina Borok",1930,"2004",0,"mathematical analysis","mathematician","UKR",74
"Ingram Olkin",1920,"2016",1,"combinatorics","mathematician","USA",96
"Arthur Lyon Bowley",1860,"1957",1,"economics","economist","CAN",97
"Georges Henri Halphen",1840,"1889",1,"algebraic geometry","mathematician","BRB",49
"George David Birkhoff",1880,"1944",0,"topology","mathematician","USA",64
"J. H. van Lint",1930,"2004",1,"combinatorics","mathematician","IDN",74
"Felice Casorati (mathematician)",1830,"1890",0,"mathematical analysis","mathematician","COL",60
"Nicholas Metropolis",1910,"1999",1,"physics","mathematician","BLZ",89
"Chris Heyde",1930,"2008",0,"probability theory","mathematician","AUS",78
"Raoul Bott",1920,"2005",1,"geometry","mathematician","HUN",85
"Boris Vladimirovich Gnedenko",1910,"1995",1,"probability theory","mathematician","RUS",85
"Eberhard Hopf",1900,"1983",1,"topology","mathematician","AUT",83
"Abraham Fraenkel",1890,"1965",1,"set theory","mathematician","DEU",75
"Hans Hahn (mathematician)",1870,"1934",1,"set theory","mathematician","AUT",64
"Raoul Bricard",1870,"1943",1,"geometry","mathematician","CAN",73
"Olry Terquem",1780,"1862",1,"geometry","mathematician","AUS",82
"Aleksandr Khinchin",1890,"1959",1,"probability theory","mathematician","RUS",69
"Egbert van Kampen",1900,"1942",0,"topology","mathematician","BEL",42
"Elwin Bruno Christoffel",1820,"1900",0,"differential geometry","mathematician","DEU",80
"Grégoire de Saint-Vincent",1580,"1667",0,"geometry","mathematician","BEL",87
"Victor Puiseux",1820,"1883",0,"mathematics","mathematician","FRA",63
"Georg Scheffers",1860,"1945",0,"differential geometry","mathematician","DEU",85
"Michel Loève",1900,"1979",0,"probability theory","mathematician","AUS",79
"Stanislaw Jaskowski",1900,"1965",0,"logic","mathematician","JAM",65
"Jean-Étienne Montucla",1720,"1799",0,"history of mathematics","mathematician","ATG",79
"Leopold Gegenbauer",1840,"1903",0,"mathematics","mathematician","AUT",63
"Olaus Henrici",1840,"1918",1,"mathematics","mathematician","DEU",78
"Georg Mohr",1640,"1697",0,"mathematics","mathematician","DNK",57
"Henri Dulac",1870,"1955",0,"mathematics","mathematician","FRA",85
"August Adler",1860,"1923",0,"geometry","mathematician","CZE",63
"Sergei Sobolev",1900,"1989",1,"mathematical physics","mathematician","RUS",89
"Brian Hartley",1930,"1994",0,"group theory","mathematician","GBR",64
"Stefan Mazurkiewicz",1880,"1945",0,"mathematical analysis","mathematician","JAM",65
"Carl Benjamin Boyer",1900,"1976",1,"history of mathematics","mathematician","USA",76
"John Selfridge",1920,"2010",0,"number theory","mathematician","USA",90
"Percy Alexander MacMahon",1850,"1929",1,"combinatorics","mathematician","MLT",79
"Louis J. Mordell",1880,"1972",1,"number theory","mathematician","BRA",92
"Jean Delsarte",1900,"1968",1,"mathematical analysis","mathematician","FRA",68
"E. M. V. Krishnamurthy",1930,"2012",1,"graph theory","mathematician","IND",82
"Friedrich Wilhelm Levi",1880,"1966",0,"group theory","mathematician","FRA",86
"Ivan Ivanov (mathematician)",1860,"1939",0,"number theory","mathematician","RUS",79
"Sergei Nikolaevich Chernikov",1910,"1987",1,"group theory","mathematician","RUS",77
"Alexandru Ghika",1900,"1964",0,"mathematical analysis","mathematician","ROU",64
"Sergey Mergelyan",1920,"2008",1,"mathematical analysis","mathematician","UKR",88
"Pierre de Fermat",1600,"1665",0,"number theory","mathematician","FRA",65
"Giuseppe Vitali",1870,"1932",0,"mathematical analysis","mathematician","ITA",62
"John Maynard Smith",1920,"2004",1,"evolutionary biology","biologist","BLZ",84
"László Rédei",1900,"1980",1,"Q3968","mathematician","HUN",80
"Boris Levin",1900,"1993",0,"Function theory","mathematician","UKR",93
"Margherita Piazzola Beloch",1870,"1976",0,"algebraic geometry","mathematician","ITA",106
"L. E. J. Brouwer",1880,"1966",1,"mathematical analysis","mathematician","NLD",86
"Ernst Meissel",1820,"1895",0,"number theory","astronomer","DEU",75
"Kurt Reidemeister",1890,"1971",0,"topology","mathematician","AUS",81
"Paul Erdos",1910,"1996",1,"probability theory","mathematician","HUN",86
"Robert G. Bartle",1920,"2003",0,"mathematical analysis","mathematician","NIC",83
"Samuel Dickstein (mathematician)",1850,"1939",0,"Q3968","mathematician","JAM",89
"Vojtech Jarník",1890,"1970",0,"mathematical physics","mathematician","CZE",80
"Robert Daniel Carmichael",1870,"1967",0,"number theory","mathematician","BLZ",97
"Wassily Hoeffding",1910,"1991",0,"probability theory","mathematician","CAN",81
"Jon Folkman",1930,"1969",0,"lattice","mathematician","USA",39
"Giovanni Battista Amici",1780,"1863",1,"astronomy","astronomer","ITA",83
"George Boole",1810,"1864",1,"mathematical logic","mathematician","ARG",54
"Ludwig Immanuel Magnus",1790,"1861",0,"geometry","mathematician","COL",71
"Tatyana Pavlovna Ehrenfest",1900,"1984",0,"combinatorics","mathematician","AUT",84
"Martin Kneser",1920,"2004",1,"number theory","mathematician","DEU",84
"Antoine Augustin Cournot",1800,"1877",0,"economics","mathematician","AUT",77
"Richard von Mises",1880,"1953",0,"probability theory","mathematician","UKR",73
"Max Mason",1870,"1961",0,"mathematical analysis","mathematician","CAN",91
"Kazimierz Bartel",1880,"1941",1,"mathematics","mathematician","UKR",61
"Willem Jacob van Stockum",1910,"1944",0,"general relativity","physicist","NLD",34
"Alexander Esenin-Volpin",1920,"2016",0,"mathematical logic","mathematician","RUS",96
"Ruslan Stratonovich",1930,"1997",1,"probability theory","mathematician","RUS",67
"Victor Schlegel",1840,"1905",0,"geometry","mathematician","DEU",65
"Virgil Snyder",1860,"1950",0,"algebraic geometry","mathematician","MYS",90
"Kentaro Yano (mathematician)",1910,"1993",0,"differential geometry","mathematician","JPN",83
"Alfred Barnard Basset",1850,"1930",1,"algebraic geometry","mathematician","BLZ",80
"Wladyslaw Orlicz",1900,"1990",0,"functional analysis","mathematician","POL",90
"Boleslav Mlodzeevskii",1850,"1923",0,"differential geometry","mathematician","RUS",73
"Leonhard Euler",1700,"1783",0,"mathematical analysis","mathematician","BEL",83
"Nikolay Krasovsky",1920,"2012",1,"control theory","mathematician","RUS",92
"Abdus Salam",1920,"1996",1,"quantum field theory","physicist","IND",76
"Corrado Gini",1880,"1965",0,"economics","economist","ITA",85
"Thomas W. Hungerford",1930,"2014",0,"Q3968","mathematician","AUS",84
"John Henry Poynting",1850,"1914",1,"physics","physicist","BOL",64
"Edward Waring",1730,"1798",1,"number theory","mathematician","GBR",68
"Johann Heinrich Lambert",1720,"1777",0,"physics","mathematician","FRA",57
"Caroline Herschel",1750,"1848",1,"astronomy","astronomer","CAN",98
"Walther von Dyck",1850,"1934",1,"combinatorics","mathematician","DEU",84
"André-Marie Ampère",1770,"1836",1,"electromagnetism","physicist","ATG",66
"Eugène Charles Catalan",1810,"1894",0,"combinatorics","mathematician","BEL",84
"Émile Léonard Mathieu",1830,"1890",0,"group theory","mathematician","AUS",60
"Otto Blumenthal",1870,"1944",0,"mathematics","mathematician","DEU",74
"Giusto Bellavitis",1800,"1880",0,"algebraic geometry","mathematician","ITA",80
"Hirotugu Akaike",1920,"2009",1,"statistics","mathematician","JPN",89
"Alexandre-Théophile Vandermonde",1730,"1796",0,"Q3968","mathematician","CAN",66
"Jack Kiefer (statistician)",1920,"1981",1,"mathematics","mathematician","COL",61
"George Batchelor",1920,"2000",1,"mechanics","mathematician","AUS",80
"Petr Vopenka",1930,"2015",1,"set theory","mathematician","CZE",85
"Peter Gavin Hall",1950,"2016",1,"probability theory","mathematician","AUS",66
"Sophie Germain",1770,"1831",1,"number theory","mathematician","CAN",61
"Victor Shestakov",1900,"1987",0,"mathematics","mathematician","RUS",87
"Guillaume de lHôpital",1660,"1704",0,"mathematical analysis","mathematician","CAN",44
"Roger Cotes",1680,"1716",1,"mathematical analysis","mathematician","GBR",36
"Gilles de Roberval",1600,"1675",0,"mathematics","philosopher","FRA",75
"Lorenz Leonard Lindelöf",1820,"1908",0,"analytic geometry","mathematician","FIN",88
"Pasquale del Pezzo",1850,"1936",0,"algebraic geometry","mathematician","COL",86
"John Wilson (mathematician)",1740,"1793",1,"number theory","mathematician","GBR",53
"Viggo Brun",1880,"1978",1,"number theory","mathematician","ESP",98
"Carl Anton Bretschneider",1800,"1878",0,"geometry","mathematician","AUT",78
"Olga Bondareva",1930,"1991",0,"game theory","economist","RUS",61
"Georg Cantor",1840,"1918",1,"set theory","mathematician","RUS",78
"Harry Vandiver",1880,"1973",1,"number theory","mathematician","BRA",93
"Hans-Egon Richert",1920,"1993",0,"number theory","mathematician","DEU",73
"Hermann Weyl",1880,"1955",1,"differential geometry","mathematician","DEU",75
"Thomas L. Saaty",1920,"2017",0,"queueing theory","mathematician","AZE",97
"John Venn",1830,"1923",1,"mathematical logic","mathematician","GBR",93
"Theodor Schönemann",1810,"1868",0,"number theory","mathematician","POL",58
"Semyon Aranovich Gershgorin",1900,"1933",0,"Q3968","mathematician","BLR",33
"Hermann Schwarz",1840,"1921",0,"mathematics","mathematician","RUS",81
"Friedrich Hartogs",1870,"1943",0,"mathematical analysis","mathematician","BEL",73
"Carl Hindenburg",1740,"1808",0,"probability theory","mathematician","CAN",68
"Conrad Henfling",1640,"1716",0,"number theory","mathematician","DEU",76
"Ziauddin Ahmad",1870,"1947",1,"differential geometry","mathematician","IND",77
"Georges Valiron",1880,"1955",1,"mathematical analysis","mathematician","ATG",75
"Christiaan Huygens",1620,"1695",0,"mathematics","astronomer","NLD",75
"Roland Fraïssé",1920,"2008",0,"mathematical logic","mathematician","FRA",88
"Tadashi Nakayama (mathematician)",1910,"1964",0,"Q3968","mathematician","JPN",54
"Aleksei Pogorelov",1910,"2002",1,"differential geometry","mathematician","RUS",92
"Tibor Szele",1910,"1955",1,"Q3968","mathematician","HUN",45
"Lyudmila Keldysh",1900,"1976",1,"set theory","mathematician","RUS",76
"John Riordan (mathematician)",1900,"1988",0,"combinatorics","mathematician","AUS",88
"Stanislaw Saks",1890,"1942",0,"mathematical analysis","mathematician","POL",52
"George Szekeres",1910,"2005",0,"combinatorics","mathematician","HUN",95
"Zahid Khalilov",1910,"1974",0,"functional analysis","mathematician","GEO",64
"William Fogg Osgood",1860,"1943",0,"mathematical analysis","mathematician","BOL",83
"Yegor Ivanovich Zolotarev",1840,"1878",1,"number theory","mathematician","RUS",38
"Paul Tannery",1840,"1904",0,"history of mathematics","mathematician","FRA",64
"Francis Galton",1820,"1911",1,"probability theory","mathematician","GBR",91
"Miroslav Fiedler",1920,"2015",1,"graph theory","mathematician","CZE",95
"Paul Mahlo",1880,"1971",0,"set theory","mathematician","DEU",91
"David P. Robbins",1940,"2003",0,"combinatorics","mathematician","AUS",63
"Dénes Konig",1880,"1944",0,"combinatorics","mathematician","HUN",64
"Nikolai Günther",1870,"1941",1,"differential equation","mathematician","RUS",71
"Herbert Robbins",1910,"2001",1,"mathematics","mathematician","CRI",91
"Viktor Wagner",1900,"1981",1,"Q3968","mathematician","RUS",81
"Alfred Tarski",1900,"1983",1,"logic","mathematician","JAM",83
"Daniel Kan",1920,"2013",0,"topology","mathematician","COL",93
"Vladimir Abramovich Rokhlin",1910,"1984",0,"algebraic geometry","mathematician","AZE",74
"Nicolae Popescu",1930,"2010",0,"Q3968","mathematician","ROU",80
"Andrey Kolmogorov",1900,"1987",1,"probability theory","mathematician","RUS",87
"James H. Wilkinson",1910,"1986",1,"numerical linear algebra","mathematician","GBR",76
"Michael Lvovitch Tsetlin",1920,"1966",0,"game theory","mathematician","RUS",46
"Paul Ehrenfest",1880,"1933",0,"theoretical physics","physicist","AUT",53
"Eugene Dynkin",1920,"2014",1,"Q3968","mathematician","RUS",94
"Isaak Russman",1930,"2005",0,"mathematical model","mathematician","RUS",75
"Thomas Harriot",1560,"1621",0,"Q3968","mathematician","BRB",61
"Victor Glushkov",1920,"1982",1,"Q3968","mathematician","RUS",62
"Béla Szokefalvi-Nagy",1910,"1998",1,"mathematical analysis","mathematician","ROU",88
"Karl Pearson",1850,"1936",1,"mathematical statistics","mathematician","BLZ",86
"Rudolf Luneburg",1900,"1949",0,"geometry","mathematician","DEU",49
"James Ivory (mathematician)",1760,"1842",1,"mathematics","mathematician","AUS",82
"George Samuel Hurst",1920,"2010",0,"Health physics","","ITA",90
"Herbert Scarf",1930,"2015",1,"economics","mathematician","BRA",85
"William S. Massey",1920,"2017",0,"topology","mathematician","BLZ",97
"Christos Papakyriakopoulos",1910,"1976",1,"topology","mathematician","GRC",66
"D. R. Fulkerson",1920,"1976",0,"combinatorics","mathematician","USA",56
"Gheorghe <U+021A>i<U+021B>eica",1870,"1939",0,"differential geometry","mathematician","ROU",69
"Ferdinand von Lindemann",1850,"1939",1,"number theory","mathematician","CAN",89
"Delfino Codazzi",1820,"1873",0,"differential geometry","mathematician","COD",53
"Jürgen Neukirch",1930,"1997",0,"number theory","mathematician","DEU",67
"Oswald Veblen",1880,"1960",0,"geometry","mathematician","PNG",80
"Sergey Chaplygin",1860,"1942",1,"mechanics","mathematician","RUS",82
"Josip Plemelj",1870,"1967",1,"mathematics","mathematician","SVN",97
"George Abram Miller",1860,"1951",0,"group theory","mathematician","USA",91
"Alfred Kempe",1840,"1922",1,"graph theory","mathematician","AUS",82
"Gunter Wyszecki",1920,"1985",0,"mathematics","mathematician","RUS",65
"Joram Lindenstrauss",1930,"2012",1,"functional analysis","mathematician","ISR",82
"John Lennard-Jones",1890,"1954",1,"physics","mathematician","GBR",64
"Mark Semenovich Pinsker",1920,"2003",1,"coding theory","mathematician","RUS",83
"Mark Kac",1910,"1984",1,"probability theory","mathematician","POL",74
"Victor Borisov",1930,"2013",0,"differential equation","mathematician","RUS",83
"Kurt Schütte",1900,"1998",0,"mathematical logic","mathematician","DEU",98
"Pierre Alphonse Laurent",1810,"1854",0,"mathematical analysis","mathematician","CAN",44
"Giuseppe Lauricella",1860,"1913",0,"mathematics","mathematician","ITA",53
"Nicolaus II Bernoulli",1690,"1726",0,"mathematical analysis","mathematician","BEL",36
"Thorvald N. Thiele",1830,"1910",0,"mathematics","mathematician","DNK",80
"Philippe Flajolet",1940,"2011",1,"computer science","computer scientist","ATG",71
"Giuseppe Peano",1850,"1932",0,"interlinguistics","mathematician","ITA",82
"Nicholas Mercator",1620,"1687",0,"mathematics","mathematician","DEU",67
"Évariste Galois",1810,"1832",0,"group theory","mathematician","FRA",22
"Andreas Cellarius",1590,"1665",0,"astronomy","astronomer","DEU",75
"Iosif Vorovich",1920,"2001",1,"mechanics","mathematician","RUS",81
"Lev Pontryagin",1900,"1988",1,"topology","mathematician","RUS",88
"Yaroslav Lopatinskii",1900,"1981",1,"mathematical analysis","mathematician","GEO",81
"Corrado Segre",1860,"1924",0,"differential geometry","mathematician","ITA",64
"Harold Scott MacDonald Coxeter",1900,"2003",1,"geometry","mathematician","BLZ",103
"John von Neumann",1900,"1957",1,"functional analysis","mathematician","HUN",57
"Torsten Carleman",1890,"1949",1,"mathematical analysis","mathematician","SWE",59
"David Gilbarg",1910,"2001",0,"partial differential equation","mathematician","BOL",91
"Alfredo Capelli",1850,"1910",0,"mathematics","mathematician","AFG",60
"Giuseppe Battaglini",1820,"1894",0,"geometry","mathematician","ITA",74
"Hans Riesel",1920,"2014",0,"number theory","mathematician","SWE",94
"Marino Ghetaldi",1560,"1626",0,"mathematics","mathematician","HRV",66
"Theodor von Oppolzer",1840,"1886",0,"astronomy","mathematician","CZE",46
"Philipp von Jolly",1800,"1884",0,"physics","mathematician","DEU",84
"Johann Friedrich Pfaff",1760,"1825",0,"mathematical analysis","mathematician","DEU",65
"Hans Freudenthal",1900,"1990",1,"topology","mathematician","DEU",90
"Hubert Stanley Wall",1900,"1971",0,"mathematical analysis","mathematician","USA",71
"Ludvig Faddeev",1930,"2017",1,"mathematical physics","mathematician","RUS",87
"Émilie du Châtelet",1700,"1749",0,"mathematician","mathematician","CAN",49
"Édouard Lucas",1840,"1891",0,"number theory","mathematician","AUS",51
"James Earl Baumgartner",1940,"2011",0,"mathematical logic","mathematician","USA",71
"Valery Senderov",1940,"2014",0,"functional analysis","mathematician","RUS",74
"Boris Trakhtenbrot",1920,"2016",1,"mathematical logic","mathematician","MDA",96
"Danilo Blanuša",1900,"1987",0,"mathematics","mathematician","BIH",87
"Pyotr Novikov",1900,"1975",1,"group theory","mathematician","RUS",75
"Emanuel Sperner",1900,"1980",0,"combinatorics","mathematician","POL",80
"Pál Turán",1910,"1976",1,"combinatorics","mathematician","HUN",66
"Øystein Ore",1890,"1968",1,"combinatorics","mathematician","DNK",78
"Nina Bari",1900,"1961",0,"mathematical analysis","mathematician","RUS",61
"Salvatore Pincherle",1850,"1936",0,"mathematical analysis","mathematician","COL",86
"Siegfried Gottwald",1940,"2015",1,"mathematical logic","mathematician","AUT",75
"Irénée-Jules Bienaymé",1790,"1878",0,"statistics","statistician","CAN",88
"Vladimir Zakalyukin",1950,"2011",0,"mathematics","mathematician","RUS",61
"Oscar Zariski",1890,"1986",1,"algebraic geometry","mathematician","BLR",96
"John Cocke",1920,"2002",1,"informatics","mathematician","HTI",82
"Abraham H. Taub",1910,"1999",1,"differential geometry","mathematician","BLZ",89
"Albert Turner Bharucha-Reid",1920,"1985",0,"probability theory","mathematician","AUS",65
"Bernhard Riemann",1820,"1866",0,"differential geometry","mathematician","DEU",46
"Evert Willem Beth",1900,"1964",0,"mathematical logic","mathematician","NLD",64
"Ivan Vidav",1910,"2015",1,"mathematics","mathematician","COL",105
"Laurent Schwartz",1910,"2002",1,"mathematics","mathematician","CAN",92
"Crispin Nash-Williams",1930,"2001",0,"graph theory","mathematician","AUS",71
"Alfred Russel Wallace",1820,"1913",1,"geometry","mathematician","CAN",93
"Alexander Alexandrovich Chuprov",1870,"1926",0,"statistics","statistician","RUS",56
"G. H. Hardy",1870,"1947",1,"mathematical analysis","mathematician","GBR",77
"Paul Cohen",1930,"2007",1,"set theory","mathematician","CAN",77
"Gian-Carlo Rota",1930,"1999",0,"combinatorics","mathematician","ITA",69
"Aldo Andreotti",1920,"1980",0,"partial differential equation","mathematician","HTI",60
"Gu Chaohao",1920,"2012",1,"mathematics","mathematician","CHN",92
"Sumner Byron Myers",1910,"1955",0,"topology","mathematician","BOL",45
"Edsger W. Dijkstra",1930,"2002",1,"informatics","mathematician","NLD",72
"Kazimierz Kuratowski",1890,"1980",0,"topology","mathematician","JAM",90
"Joseph-Louis Lagrange",1730,"1813",1,"mathematical analysis","mathematician","BLR",83
"François Viète",1540,"1603",0,"Q3968","mathematician","FRA",63
"Johann Christian Martin Bartels",1760,"1836",0,"differential geometry","mathematician","AUS",76
"Samuel Eilenberg",1910,"1998",1,"topology","mathematician","JAM",88
"Alan Turing",1910,"1954",1,"cryptanalysis","computer scientist","GBR",44
"Erik Ivar Fredholm",1860,"1927",1,"integral equation","mathematician","SWE",67
"Henri Cartan",1900,"2008",1,"mathematical analysis","mathematician","BOL",108
"Luther P. Eisenhart",1870,"1965",0,"differential geometry","mathematician","AUS",95
"Mark Krein",1900,"1989",1,"functional analysis","mathematician","RUS",89
"Dmitry Grave",1860,"1939",1,"differential equation","mathematician","RUS",79
"Karl Rohn",1850,"1920",0,"geometry","mathematician","DEU",70
"Ott-Heinrich Keller",1900,"1990",1,"geometry","mathematician","DEU",90
"Valentin Turchin",1930,"2010",0,"physics","physicist","BLR",80
"Boris Demidovich",1900,"1977",1,"differential equation","mathematician","BLR",77
"Robert Phelps",1920,"2013",0,"functional analysis","mathematician","BOL",93
"George Gallup",1900,"1984",0,"political science","statistician","USA",84
"Tosio Kato",1910,"1999",0,"partial differential equation","mathematician","COD",89
"Arnold Walfisz",1890,"1962",0,"number theory","mathematician","JAM",72
"Philipp Furtwängler",1860,"1940",0,"number theory","mathematician","DEU",80
"George Kempf",1940,"2002",0,"algebraic geometry","mathematician","HTI",62
"Carl Størmer",1870,"1957",1,"number theory","mathematician","NOR",87
"Andreas von Ettingshausen",1790,"1878",0,"mathematics","mathematician","AUS",88
"Pierre Samuel",1920,"2009",0,"algebraic geometry","mathematician","CAN",89
"Josif Shtokalo",1890,"1987",1,"differential equation","mathematician","UKR",97
"D. R. Kaprekar",1900,"1986",0,"number theory","mathematician","IND",86
"Jacques Charles François Sturm",1800,"1855",1,"mathematical physics","mathematician","CHE",55
"Kenneth Appel",1930,"2013",0,"graph theory","mathematician","AUS",83
"Ulisse Dini",1840,"1918",0,"mathematics","mathematician","COL",78
"Boris Galerkin",1870,"1945",1,"mechanics","mathematician","BLR",75
"Erich Kähler",1900,"2000",0,"algebraic geometry","mathematician","DEU",100
"Bartel Leendert van der Waerden",1900,"1996",1,"Q3968","mathematician","COL",96
"Eugenio Beltrami",1830,"1900",0,"differential geometry","mathematician","CAN",70
"Gilbert Hunt",1910,"2008",0,"probability theory","tennis player","ARG",98
"C. Brian Haselgrove",1920,"1964",0,"number theory","mathematician","GBR",44
"Eugen Netto",1840,"1919",0,"mathematics","mathematician","BEL",79
"George W. Whitehead",1910,"2004",1,"topology","mathematician","USA",94
"Oskar Bolza",1850,"1942",0,"geometry","mathematician","LTU",92
"Lodovico Ferrari",1520,"1565",0,"Q3968","mathematician","ITA",45
"Patrick Billingsley",1920,"2011",0,"probability theory","mathematician","USA",91
"James Joseph Sylvester",1810,"1897",1,"Q3968","mathematician","BLZ",87
"Robert Frucht",1900,"1997",0,"graph theory","mathematician","COL",97
"Lev Gutenmaher",1900,"1981",1,"numerical analysis","mathematician","UKR",81
"Abraham Gotthelf Kästner",1710,"1800",1,"mathematics","mathematician","DEU",90
"Mikhail Lavrentyev",1900,"1980",1,"calculus of variations","mathematician","AFG",80
"Jeremiah Horrocks",1610,"1641",0,"astronomy","astronomer","AUS",31
"Marcel Berger",1920,"2016",1,"geometry","mathematician","CAN",96
"Bernard Bolzano",1780,"1848",0,"mathematical analysis","mathematician","CZE",68
"Ernest Julius Wilczynski",1870,"1932",0,"differential geometry","mathematician","DEU",62
"Chung Kai-lai",1910,"2009",1,"probability theory","mathematician","CHN",99
"Taqi ad-Din Muhammad ibn Maruf",1520,"1585",0,"astronomy","mathematician","SYR",65
"Paul Montel",1870,"1975",1,"mathematics","mathematician","FRA",105
"Fridrikh Karpelevich",1920,"2000",0,"Q3968","mathematician","RUS",80
"J. H. C. Whitehead",1900,"1960",1,"topology","mathematician","IND",60
"Jacob Bernoulli",1650,"1705",0,"probability theory","mathematician","BEL",55
"György Hajós",1910,"1972",1,"Q3968","mathematician","HUN",62
"Wolfgang Doeblin",1910,"1940",0,"probability theory","mathematician","COL",30
"Boris Berezovsky (businessman)",1940,"2013",1,"mathematics","entrepreneur","RUS",73
"Alice T. Schafer",1910,"2009",0,"topology","mathematician","AUS",99
"Walter Feit",1930,"2004",1,"group theory","mathematician","AUT",74
"Bella Subbotovskaya",1930,"1982",0,"mathematics","mathematician","RUS",52
"Albert Girard",1590,"1632",0,"mathematics","mathematician","FRA",42
"Carlo Severini",1870,"1951",0,"mathematical analysis","mathematician","ITA",81
"Nicolai A. Vasiliev",1880,"1940",0,"logic","mathematician","AFG",60
"Marquis de Condorcet",1740,"1794",0,"mathematics","philosopher","FRA",54
"Thomas Bayes",1700,"1761",1,"probability theory","mathematician","BLZ",61
"Ernest de Jonquières",1820,"1901",1,"geometry","mathematician","FRA",81
"Bernard Frénicle de Bessy",1600,"1675",0,"combinatorics","mathematician","CAN",75
"Florian Cajori",1850,"1930",0,"history of mathematics","mathematician","CHE",80
"K. G. Ramanathan",1920,"1992",1,"number theory","mathematician","IND",72
"Alexey Lyapunov",1910,"1973",1,"cybernetics","mathematician","RUS",63
"Giovanni Domenico Cassini",1620,"1712",1,"astronomy","selenographer","ITA",92
"Israel Gelfand",1910,"2009",1,"mathematical analysis","mathematician","UKR",99
"Samuel Earnshaw",1800,"1888",0,"physics","mathematician","AUS",88
"Anders Johan Lexell",1740,"1784",0,"astronomy","astronomer","FIN",44
"Karl Seebach",1910,"2007",0,"mathematics","mathematician","DEU",97
"Simon Antoine Jean LHuilier",1750,"1840",1,"mathematics","mathematician","CHE",90
"Robert Lawson Vaught",1920,"2002",1,"model theory","mathematician","ESP",82
"Herbert Wilf",1930,"2012",1,"combinatorics","mathematician","BRA",82
"William Philip Hiern",1830,"1925",1,"botany","mathematician","AUS",95
"Johann III Bernoulli",1740,"1807",0,"mathematics","mathematician","BEL",67
"Thomas Kirkman",1800,"1895",1,"combinatorics","mathematician","AUS",95
"André Sainte-Laguë",1880,"1950",1,"graph theory","mathematician","FRA",70
"Anatoli Prudnikov",1920,"1999",0,"operational calculus","mathematician","RUS",79
"Federigo Enriques",1870,"1946",0,"algebraic geometry","mathematician","ITA",76
"William Burnside",1850,"1927",1,"group theory","mathematician","BLZ",77
"Francesco Brioschi",1820,"1897",1,"mathematics","mathematician","AFG",77
"George Kingsley Zipf",1900,"1950",1,"linguistics","linguist","BHS",50
"Karl Georg Christian von Staudt",1790,"1867",0,"geometry","mathematician","DEU",77
"Cyparissos Stephanos",1850,"1917",0,"algebra","mathematician","GBR",67
"Georgios Remoundos",1870,"1928",0,"mathematics","university teacher","GRC",58
"Wilhelm Magnus",1900,"1990",1,"group theory","mathematician","COL",90
"Alfred van der Poorten",1940,"2010",0,"number theory","mathematician","COL",70
"Mary Somerville",1780,"1872",1,"popular science","mathematician","GBR",92
"Maurice René Fréchet",1870,"1973",1,"mathematical analysis","mathematician","FRA",103
"August Leopold Crelle",1780,"1855",0,"mathematics","mathematician","DEU",75
"Zoia Ceau<U+0219>escu",1940,"2006",0,"mathematical analysis","mathematician","ROU",66
"Karol Borsuk",1900,"1982",0,"topology","mathematician","JAM",82
"Paul Cohn",1920,"2006",1,"Q3968","mathematician","DEU",86
"William J. LeVeque",1920,"2007",0,"number theory","mathematician","AUS",87
"Norman Steenrod",1910,"1971",1,"topology","mathematician","CAN",61
"W. T. Tutte",1910,"2002",1,"combinatorics","mathematician","AUS",92
"Adolf Lindenbaum",1900,"1941",0,"set theory","mathematician","JAM",41
"Subrahmanyan Chandrasekhar",1910,"1995",1,"astrophysics","mathematician","CMR",85
"Thomas Bartholin",1610,"1680",0,"medicine","mathematician","DNK",70
"Robert Steinberg",1920,"2014",0,"group theory","mathematician","MDA",94
"Andrey Nikolayevich Tikhonov",1900,"1993",1,"topology","mathematician","ARM",93
"Hellmuth Kneser",1890,"1973",0,"group theory","mathematician","EST",83
"Paul T. Bateman",1910,"2012",0,"number theory","mathematician","BRA",102
"Edmund Hlawka",1910,"2009",1,"number theory","mathematician","AUT",99
"Edward Charles Titchmarsh",1890,"1963",1,"mathematical analysis","mathematician","AUS",73
"Gerhard Ringel",1910,"2008",0,"graph theory","mathematician","AUT",98
"Georges-Louis Leclerc, Comte de Buffon",1700,"1788",1,"biology","botanist","FRA",88
"Meyer Bockstein",1910,"1990",0,"topology","mathematician","RUS",80
"Arthur Cayley",1820,"1895",1,"graph theory","mathematician","CAN",75
"Otto E. Neugebauer",1890,"1990",1,"mathematics","mathematician","AUT",100
"Georg Alexander Pick",1850,"1942",0,"mathematics","mathematician","AUT",92
"Jacques Ozanam",1640,"1718",0,"mathematics","mathematician","FRA",78
"James Mercer (mathematician)",1880,"1932",1,"mathematical analysis","mathematician","AUS",52
"William Oughtred",1570,"1660",0,"mathematics","mathematician","AUS",90
"Karl Weierstrass",1810,"1897",1,"mathematical analysis","mathematician","DEU",87
"David Khorol",1920,"1990",1,"geophysics","mathematician","RUS",70
"Johannes de Groot",1910,"1972",0,"topology","mathematician","DEU",62
"Marvin Knopp",1930,"2011",0,"mathematical analysis","mathematician","BLZ",81
"Arthur Schuster",1850,"1934",1,"seismology","physicist","DEU",84
"Mkhitar Djrbashian",1910,"1994",1,"Function theory","mathematician","ARM",84
"Hugh Everett III",1930,"1982",0,"Q944","mathematician","ARG",52
"Andrei Zelevinsky",1950,"2013",1,"mathematical analysis","mathematician","RUS",63
"John Playfair",1740,"1819",1,"mathematics","mathematician","AUS",79
"Richard Crandall",1940,"2012",0,"number theory","computer scientist","USA",72
"Johannes Kepler",1570,"1630",0,"optics","naturalist","DEU",60
"Grigorii Fichtenholz",1880,"1959",1,"calculus","mathematician","UKR",79
"Douglas Hartree",1890,"1958",1,"theoretical physics","mathematician","AUS",68
"Walter Rudin",1920,"2010",0,"mathematical analysis","mathematician","AUT",90
"Luis Santaló",1910,"2001",1,"differential geometry","mathematician","ESP",91
"Shaun Wylie",1910,"2009",0,"topology","mathematician","BRB",99
"Rudolf E. Kálmán",1930,"2016",1,"control theory","mathematician","HUN",86
"Gregorio Ricci-Curbastro",1850,"1925",0,"differential geometry","mathematician","COL",75
"Mikhail Postnikov",1920,"2004",1,"topology","mathematician","RUS",84
"Simion Stoilow",1880,"1961",0,"mathematical analysis","mathematician","ROU",81
"Ralph Faudree",1930,"2015",1,"combinatorics","mathematician","BRB",85
"Johann Friedrich Hennert",1730,"1813",0,"mathematical analysis","mathematician","COL",83
"Igor Shafarevich",1920,"2017",1,"algebraic geometry","mathematician","UKR",97
"Francis Dominic Murnaghan (mathematician)",1890,"1976",0,"group theory","mathematician","GBR",86
"Radha Laha",1930,"1999",0,"probability theory","mathematician","BLZ",69
"Gaetano Fichera",1920,"1996",1,"mathematical analysis","mathematician","ITA",76
"Willard Van Orman Quine",1900,"2000",1,"model theory","mathematician","USA",100
"Pavel Urysohn",1890,"1924",0,"topology","mathematician","UKR",34
"Étienne Laspeyres",1830,"1913",0,"statistics","economist","BEL",83
"Isaak Yaglom",1920,"1988",0,"geometry","mathematician","UKR",68
"Shreeram Shankar Abhyankar",1930,"2012",0,"algebraic geometry","mathematician","IND",82
"Nicolas Fuss",1750,"1826",0,"Q3968","mathematician","BEL",76
"Errett Bishop",1920,"1983",0,"mathematical analysis","mathematician","ARG",63
"Johannes Boersma",1930,"2004",0,"mathematical analysis","mathematician","NLD",74
"Max August Zorn",1900,"1993",0,"Q3968","mathematician","DEU",93
"Adam Olearius",1600,"1671",0,"geography","mathematician","DEU",71
"Max Newman",1890,"1984",1,"mathematics","cryptographer","BLZ",94
"Richard Rado",1900,"1989",1,"combinatorics","mathematician","COL",89
"Wolfgang Heinrich Johannes Fuchs",1910,"1997",1,"mathematical analysis","mathematician","DEU",87
"Leopold Vietoris",1890,"2002",1,"topology","mathematician","AUT",112
"Clarence Raymond Adams",1890,"1965",0,"mathematical analysis","mathematician","USA",75
"Gábor Szego",1890,"1985",0,"mathematical analysis","mathematician","HUN",95
"Giambattista Benedetti",1530,"1590",0,"mechanics","mathematician","CAN",60
"John Napier",1550,"1617",0,"mathematics","theologian","GBR",67
"George Dantzig",1910,"2005",1,"mathematics","mathematician","AUS",95
"Derrick Norman Lehmer",1860,"1938",0,"number theory","mathematician","AUS",78
"Shimshon Amitsur",1920,"1994",1,"Q3968","mathematician","BOL",74
"Jacques-Louis Lions",1920,"2001",1,"mathematical analysis","mathematician","AUT",81
"Kikuchi Dairoku",1850,"1917",1,"mathematics","mathematician","IDN",67
"Naum Akhiezer",1900,"1980",0,"mathematical analysis","mathematician","BLR",80
"Karl Mikhailovich Peterson",1820,"1881",0,"geometry","mathematician","AFG",61
"Nikolaus Hofreiter",1900,"1990",1,"number theory","mathematician","AUT",90
"Nathaniel Bliss",1700,"1764",1,"astronomy","mathematician","GBR",64
"Sergei Natanovich Bernstein",1880,"1968",1,"mathematical analysis","mathematician","UKR",88
"Paul Sophus Epstein",1880,"1966",0,"theoretical physics","mathematician","JAM",86
"Naum Ya. Vilenkin",1920,"1991",0,"combinatorics","mathematician","RUS",71
"Zsolt Baranyai",1940,"1978",0,"combinatorics","mathematician","HUN",38
"Géza Fodor (mathematician)",1920,"1977",0,"set theory","mathematician","HUN",57
"Sofia Kovalevskaya",1850,"1891",1,"mathematics","mathematician","RUS",41
"Robert Lee Moore",1880,"1974",0,"topology","mathematician","CAN",94
"Irving Kaplansky",1910,"2006",1,"Q3968","mathematician","AUS",96
"Robert Recorde",1510,"1558",0,"physics","mathematician","GBR",48
"Elisha Netanyahu",1910,"1986",0,"complex analysis","mathematician","JAM",76
"Mauro Picone",1880,"1977",0,"mathematical analysis","mathematician","ARG",97
"Nathan Fine",1910,"1994",1,"mathematical analysis","mathematician","BRA",84
"Giuseppe Veronese",1850,"1917",0,"mathematics","mathematician","ITA",67
"Israel Gohberg",1920,"2009",0,"functional analysis","mathematician","UKR",89
"Nachman Aronszajn",1900,"1980",0,"mathematical analysis","mathematician","JAM",80
"Cesare Burali-Forti",1860,"1931",0,"set theory","mathematician","HRV",71
"Harald Cramér",1890,"1985",1,"probability theory","mathematician","SWE",95
"Valery Glivenko",1890,"1940",0,"mathematical analysis","mathematician","RUS",50
"Gaspard-Gustave Coriolis",1790,"1843",0,"mathematics","mathematician","CAN",53
"Harold Davenport",1900,"1969",1,"number theory","mathematician","GBR",69
"Jean Leray",1900,"1998",1,"mathematical analysis","mathematician","BRA",98
"Stefan E. Warschawski",1900,"1989",0,"mathematical analysis","mathematician","BLR",89
"András P Huhn",1940,"1985",0,"Q3968","mathematician","HUN",45
"Czeslaw Ryll-Nardzewski",1920,"2015",1,"model theory","mathematician","LTU",95
"Norbert Wiener",1890,"1964",1,"mathematics","mathematician","BOL",74
"Anne Penfold Street",1930,"2016",0,"combinatorics","mathematician","AUS",86
"Eduard Ritter von Weber",1870,"1934",0,"mathematical analysis","mathematician","DEU",64
"Otto Stolz",1840,"1905",0,"mathematical analysis","mathematician","AUT",65
"Rodion Kuzmin",1890,"1949",0,"mathematical analysis","mathematician","BLR",59
"Jean Paul de Gua de Malves",1710,"1786",1,"geometry","mathematician","FRA",76
"Nikolay Nekhoroshev",1940,"2008",0,"catastrophe theory","mathematician","RUS",68
"Yurii Dmitrievich Sokolov",1890,"1971",1,"differential equation","mathematician","RUS",81
"Oskar Perron",1880,"1975",1,"partial differential equation","mathematician","DEU",95
"Sergio Campanato",1930,"2005",0,"partial differential equation","mathematician","CAN",75
"Seymour Papert",1920,"2016",1,"cognitive science","mathematician","ECU",96
"Pietro Cataldi",1550,"1626",0,"mathematics","mathematician","ITA",76
"Zygmunt Janiszewski",1880,"1920",0,"topology","mathematician","JAM",40
"Leon Henkin",1920,"2006",1,"mathematics","mathematician","AUS",86
"Georgii Evgenevich Shilov",1910,"1975",1,"Function theory","mathematician","BGR",65
"Edward Kofler",1910,"2007",0,"set theory","mathematician","UKR",97
"Sergey Yablonsky",1920,"1998",1,"mathematics","mathematician","RUS",78
"Heinrich August Rothe",1770,"1842",0,"combinatorics","mathematician","CAN",72
"Louis-Benjamin Francœur",1770,"1849",1,"mathematics","mathematician","CAN",79
"Henri Poincaré",1850,"1912",1,"algebraic geometry","mathematician","BOL",62
"Gino Fano",1870,"1952",0,"mathematics","mathematician","CUB",82
"Daniel Bernoulli",1700,"1782",1,"mathematical analysis","mathematician","NLD",82
"Thomas Simpson",1710,"1761",1,"mathematical analysis","mathematician","GBR",51
"Alonzo Church",1900,"1995",0,"mathematical logic","mathematician","ARG",95
"Friedrich Engel (mathematician)",1860,"1941",0,"mathematics","mathematician","CZE",81
"Gustav Elfving",1900,"1984",0,"probability theory","mathematician","FIN",84
"Giovanni Frattini",1850,"1925",0,"group theory","mathematician","BEL",75
"Isabella Bashmakova",1920,"2005",0,"Q3968","mathematician","RUS",85
"John Wallis",1610,"1703",0,"mathematics","mathematician","AUS",93
"Émile Picard",1850,"1941",1,"mathematical analysis","mathematician","CAN",91
"Béla Kerékjártó",1890,"1946",0,"topology","mathematician","HUN",56
"Oded Schramm",1960,"2008",1,"probability theory","mathematician","BOL",48
"Enzo Martinelli",1910,"1999",0,"mathematical analysis","mathematician","ITA",89
"Oliver Heaviside",1850,"1925",1,"electromagnetism","mathematician","BLZ",75
"Albert W. Tucker",1900,"1995",1,"topology","mathematician","PER",95
"Louis Couturat",1860,"1914",0,"interlinguistics","philosopher","FRA",54
"Francesco Tricomi",1890,"1978",0,"partial differential equation","mathematician","ITA",88
"Joseph Fourier",1760,"1830",1,"mathematical analysis","mathematician","FRA",70
"Abram Ilyich Fet",1920,"2007",0,"differential geometry","mathematician","UKR",87
"Joseph Alfred Serret",1810,"1885",0,"geometry","mathematician","CAN",75
"Naum Z. Shor",1930,"2006",1,"mathematical analysis","mathematician","RUS",76
"Bruno de Finetti",1900,"1985",0,"probability theory","mathematician","AUT",85
"Aryeh Dvoretzky",1910,"2008",1,"probability theory","mathematician","RUS",98
"Leonida Tonelli",1880,"1946",0,"mathematical analysis","mathematician","ITA",66
"Mikhail Kadets",1920,"2011",0,"mathematical analysis","mathematician","RUS",91
"Giulio Ascoli",1840,"1896",0,"mathematical analysis","mathematician","COL",56
"Bonaventura Cavalieri",1590,"1647",0,"mathematics","mathematician","AFG",57
"Gheorghe Vrânceanu",1900,"1979",0,"differential geometry","mathematician","BIH",79
"Stephen Rallis",1940,"2012",0,"number theory","mathematician","GBR",72
"Abraham Wald",1900,"1950",0,"functional analysis","mathematician","ROU",50
"William Rowan Hamilton",1800,"1865",1,"mathematics","mathematician","AUS",65
"Paul Halmos",1910,"2006",1,"Q3968","mathematician","HUN",96
"Adolphe Quetelet",1790,"1874",0,"mathematics","astronomer","BEL",84
"Richard Davis Anderson",1920,"2008",0,"topology","mathematician","USA",88
"Archibald Read Richardson",1880,"1954",1,"Q3968","mathematician","BLZ",74
"Michio Suzuki",1920,"1998",1,"group theory","mathematician","AGO",78
"Athanasios Papoulis",1920,"2002",1,"mathematics","mathematician","GRC",82
"Alfred Enneper",1830,"1885",0,"differential geometry","mathematician","DEU",55
"H. J. Ryser",1920,"1985",0,"combinatorics","mathematician","USA",65
"Fritz Carlson",1880,"1952",0,"mathematical analysis","mathematician","SWE",72
"Lars Ahlfors",1900,"1996",1,"mathematical analysis","mathematician","FIN",96
"Hermann Brunn",1860,"1939",0,"geometry","mathematician","BEL",79
"László Fejes Tóth",1910,"2005",1,"geometry","mathematician","HUN",95
"Alexander Grothendieck",1920,"2014",1,"algebraic geometry"," university teacher","COL",94
"Johannes Hudde",1620,"1704",0,"mathematics"," politician","COL",84
"Morris Kline",1900,"1992",1,"mathematics"," historian of mathematics","AUS",92
"Heinrich Wilhelm Brandes",1770,"1834",0,"physics"," physicist","DEU",64
"Carl Gustav Jacob Jacobi",1800,"1851",1,"differential geometry"," university teacher","DEU",51
"Luigi Cremona",1830,"1903",1,"algebraic geometry"," university teacher","COL",73
"Helmut Hasse",1890,"1979",1,"number theory"," university teacher","CMR",89
"Solomon W. Golomb",1930,"2016",1,"combinatorics"," computer scientist","COL",86
"Yehoshua Bar-Hillel",1910,"1975",0,"mathematical logic"," linguist","AUT",65
"Claude Shannon",1910,"2001",1,"probability theory"," cryptographer","USA",91
"Étienne-Louis Malus",1770,"1812",1,"optics"," physicist","CAN",42
"Børge Jessen",1900,"1993",0,"mathematical analysis"," university teacher","DNK",93
"Nail Bakirov",1950,"2010",0,"probability theory"," statistician","KAZ",60
"Erling Sverdrup",1910,"1994",0,"cryptography"," statistician","AUT",84
"Isaac Barrow",1630,"1677",0,"physics"," mathematician","BLZ",47
"Jacob Tamarkin",1880,"1945",0,"mathematical analysis"," university teacher","UKR",65
"Ludwig Boltzmann",1840,"1906",1,"theoretical physics"," chemist","AUT",66
"Sandy Green (mathematician)",1920,"2014",1,"group theory"," university teacher","AUS",94
"Charles Dupin",1780,"1873",1,"differential geometry"," politician","FRA",93
"Ivan M. Niven",1910,"1999",0,"number theory"," university teacher","CAN",89
"Anatoly Karatsuba",1930,"2008",1,"mathematical analysis"," university teacher","RUS",78
"Lev Schnirelmann",1900,"1938",0,"number theory"," topologist","BLR",38
"Henry P. H. Bromwell",1820,"1903",0,"geometry"," politician","COL",83
"Arnaud Denjoy",1880,"1974",1,"mathematics"," university teacher","FRA",94
"Jarl Waldemar Lindeberg",1870,"1932",0,"probability theory"," statistician","FIN",62
"Eric Temple Bell",1880,"1960",0,"combinatorics"," historian of mathematics","GBR",80
"John Backus",1920,"2007",1,"computer science"," computer scientist","BRA",87
"Felix Berezin",1930,"1980",0,"algebra"," physicist","RUS",50
"Wilhelm Ackermann",1890,"1962",0,"mathematics"," philosopher","DEU",72
"Ernest Michael",1920,"2013",1,"mathematical analysis"," topologist","CHE",93
"Marcel-Paul Schützenberger",1920,"1996",0,"combinatorics"," computer scientist","CAN",76
"Sergey Nikolsky",1900,"2012",1,"functional analysis"," university teacher","RUS",112
"John Edensor Littlewood",1880,"1977",1,"mathematical analysis"," university teacher","AUS",97
"Yuri Linnik",1910,"1972",1,"number theory"," statistician","UKR",62
"Claude Berge",1920,"2002",1,"graph theory"," computer scientist","CAN",82
"Charles Sanders Peirce",1830,"1914",0,"lattice"," philosopher","AUS",84
"Moritz Cantor",1820,"1920",0,"history"," historian of mathematics","DEU",100
"Saunders Mac Lane",1900,"2005",1,"Q3968"," university teacher","USA",105
"Gottfried Wilhelm Leibniz",1640,"1716",1,"mathematical analysis"," jurist","DEU",76
"Viktor Bunyakovsky",1800,"1889",0,"mathematical analysis"," teacher","AFG",89
"Leopold Kronecker",1820,"1891",0,"number theory"," university teacher","POL",71
"Gilbert Ames Bliss",1870,"1951",0,"mathematical analysis"," university teacher","BLZ",81
"Josiah Willard Gibbs",1830,"1903",1,"mathematical analysis"," physicist","BLZ",73
"Bernhard Neumann",1900,"2002",1,"group theory"," university teacher","COL",102
"Heinrich Martin Weber",1840,"1913",0,"Q3968"," university teacher","AUS",73
"Andrei Bolibrukh",1950,"2003",0,"mathematical analysis"," university teacher","RUS",53
"Arthur Milgram",1910,"1961",0,"mathematical analysis"," topologist","BRA",51
"Charles B. Morrey Jr.",1900,"1984",0,"mathematical analysis"," university teacher","USA",84
"William Sealy Gosset",1870,"1937",0,"mathematical statistics"," mathematician","AUS",67
"Sergey Stechkin",1920,"1995",0,"Function theory"," university teacher","RUS",75
"Arthur Geoffrey Walker",1900,"2001",1,"differential geometry"," physicist","CAN",101
"Eugene Wigner",1900,"1995",1,"physics"," physicist","HUN",95
"Otto Hölder",1850,"1937",0,"group theory"," university teacher","DEU",87
"Henry Helson",1920,"2010",0,"mathematical analysis"," university teacher","AUS",90
"Carl Wilhelm Borchardt",1810,"1880",0,"Q3968"," university teacher","COL",70
"Ernst Leonard Lindelöf",1870,"1946",0,"topology"," topologist","FIN",76
"Shiing-Shen Chern",1910,"2004",1,"differential geometry"," university teacher","CHN",94
"Alexis Clairaut",1710,"1765",1,"mathematics"," mathematician","CAN",55
"Edward Norton Lorenz",1910,"2008",1,"mathematics"," meteorologist","USA",98
"Raymond Louis Wilder",1890,"1982",1,"topology"," officer","AUS",92
"Friedrich Robert Helmert",1840,"1917",0,"geodesy"," geodesist","AUT",77
"Arthur Herbert Copeland",1890,"1970",1,"probability theory"," university teacher","AUS",80
"John L. Kelley",1910,"1999",0,"topology"," topologist","USA",89
"Emil Artin",1890,"1962",1,"Q3968"," university teacher","AUT",72
"Ðuro Kurepa",1900,"1993",1,"mathematics"," university teacher","HRV",93
"Ruth Moufang",1900,"1977",0,"Q3968"," educator","DEU",77
"Marston Morse",1890,"1977",1,"topology"," topologist","CAN",87
"Sofya Yanovskaya",1890,"1966",1,"Metamathematics"," historian","BLR",76
"Jakob Steiner",1790,"1863",0,"geometry"," university teacher","CHE",73
"George F C Griss",1890,"1953",0,"mathematical analysis"," philosopher","COL",63
"William Stanley Jevons",1830,"1882",1,"economics"," economist","AUS",52
"Thomas M. Cover",1930,"2012",1,"probability theory"," engineer","ARG",82
"José Celestino Mutis",1730,"1808",0,"botany"," linguist","COL",78
"Nathaniel Bowditch",1770,"1838",0,"mathematics"," astronomer","DEU",68
"Edmund Landau",1870,"1938",0,"number theory"," university teacher","COL",68
"Édouard Goursat",1850,"1936",1,"mathematical analysis"," university teacher","FRA",86
"Lipman Bers",1910,"1993",1,"mathematics"," university teacher","AFG",83
"Frank Adams",1930,"1989",1,"topology"," astronomer","AUS",59
"Jean-Victor Poncelet",1780,"1867",1,"mathematics"," politician","AUS",87
"James Whitbread Lee Glaisher",1840,"1928",1,"number theory"," astronomer","BRB",88
"Rusinš Martinš Freivalds",1940,"2016",1,"mathematics"," computer scientist","LVA",76
"Paul Dirac",1900,"1984",1,"theoretical physics"," theoretical physicist","CAN",84
"Marcel Brillouin",1850,"1948",1,"physicist"," physicist","BEL",98
"Erasmus Reinhold",1510,"1553",0,"astronomy"," astronomer","DEU",43
"Klaus Wagner",1910,"2000",0,"graph theory"," topologist","BRA",90
"Christopher Zeeman",1920,"2016",1,"topology"," topologist","IDN",96
"Daniel Gorenstein",1920,"1992",1,"group theory"," university teacher","BOL",72
"Greg Hjorth",1960,"2011",1,"mathematical logic"," chess player","AUS",51
"Nicolaas Govert de Bruijn",1910,"2012",0,"combinatorics"," university teacher","NLD",102
"Kunihiko Kodaira",1910,"1997",1,"algebraic geometry"," university teacher","JPN",87
"Andrey Markov, Jr.",1900,"1979",1,"mathematical logic"," topologist","RUS",79
"Henri Lebesgue",1870,"1941",1,"mathematical analysis"," professor","FRA",71
"George Uhlenbeck",1900,"1988",1,"theoretical physics"," university teacher","IDN",88
"Jon Barwise",1940,"2000",1,"mathematical logic"," philosopher","BLZ",60
"Horace Lamb",1840,"1934",1,"mathematics"," physicist","AUS",94
"Vyacheslav Stepanov",1880,"1950",1,"Function theory"," university teacher","RUS",70
"Jack Silver",1940,"2016",0,"set theory"," philosopher","USA",76
"Alberto Calderón",1920,"1998",1,"partial differential equation"," university teacher","ARG",78
"Konrad Knopp",1880,"1957",0,"mathematical analysis"," university teacher","COL",77
"Evangelista Torricelli",1600,"1647",0,"physics"," physicist","ITA",47
"Hermann Grassmann",1800,"1877",0,"Q3968"," physicist","POL",77
"Ronald Ross",1850,"1932",1,"malaria"," mathematician","ESP",82
"Ralph Fox",1910,"1973",1,"topology"," topologist","USA",63
"Giacinto Morera",1850,"1909",0,"mathematical analysis"," engineer","ITA",59
"J. V. Uspensky",1880,"1947",0,"probability theory"," university teacher","MNG",67
"Nikolai Efimov",1910,"1982",1,"differential geometry"," university teacher","RUS",72
"David Blackwell",1910,"2010",1,"probability theory"," statistician","CAN",100
"Donald G. Higman",1920,"2006",0,"group theory"," university teacher","CAN",86
"Francesco Severi",1870,"1961",0,"algebraic geometry"," university teacher","HRV",91
"Élie Cartan",1860,"1951",1,"differential geometry"," university teacher","FRA",91
"Alexander Kronrod",1920,"1986",1,"Function theory"," economist","RUS",66
"Arthur Prior",1910,"1969",0,"mathematical logic"," philosopher","NZL",59
"Maryam Mirzakhani",1970,"2017",1,"geometry"," topologist","IRN",47
"Evgenii Landis",1920,"1997",1,"differential calculus"," computer scientist","UKR",77
"Helge von Koch",1870,"1924",0,"number theory"," university teacher","SWE",54
"Nathan Jacobson",1910,"1999",1,"Q3968"," university teacher","JAM",89
"Tibor Gallai",1910,"1992",1,"combinatorics"," university teacher","HUN",82
"Roger Apéry",1910,"1994",1,"number theory"," university teacher","BRB",84
"Ludolph van Ceulen",1540,"1610",0,"mathematics"," professor","DEU",70
"Leonid Kantorovich",1910,"1986",1,"functional analysis"," economist","RUS",76
"Johannes Acronius Frisius",1520,"1564",0,"medicine"," physician","NLD",44
"Rafael Bombelli",1520,"1573",0,"Q3968"," engineer","ITA",53
"Richard Stone",1910,"1991",1,"economics"," statistician","BLZ",81
"Otto Schreier",1900,"1929",0,"group theory"," university teacher","AUT",29
"Kurt Gödel",1900,"1978",1,"set theory"," philosopher","CZE",78
"Kazimierz Ajdukiewicz",1890,"1963",0,"logic"," educator","UKR",73
"Claude Gaspard Bachet de Méziriac",1580,"1638",0,"number theory"," poet","FRA",58
"Egon Pearson",1890,"1980",1,"statistics"," statistician","GBR",90
"Johan de Witt",1620,"1672",0,"mathematical analysis"," politician","NLD",52
"Leonard Gillman",1910,"2009",1,"set theory"," topologist","AUS",99
"Mihailo Petrovic",1860,"1943",0,"mathematics"," scientist","BEL",83
"Robert P. Dilworth",1910,"1993",0,"lattice"," university teacher","USA",83
"Edwin Spanier",1920,"1996",1,"topology"," topologist","AUS",76
"Ernst Kolman",1890,"1979",0,"mathematics"," writer","CZE",89
"Sergei Fomin",1910,"1975",0,"abstract algebra"," university teacher","RUS",65
"Edward Nelson",1930,"2014",0,"set theory"," philosopher","USA",84
"Charles Hermite",1820,"1901",1,"Q3968"," university teacher","FRA",81
"Anatolii Goldberg",1930,"2008",0,"mathematical analysis"," university teacher","RUS",78
"Nikolai Kochin",1900,"1944",0,"mathematics"," physicist","RUS",44
"Ernst Specker",1920,"2011",0,"set theory"," university teacher","CHE",91
"Andreas Floer",1950,"1991",0,"topology"," topologist","BEL",41
"Wilhelm Blaschke",1880,"1962",1,"differential geometry"," university teacher","AUT",82
"Ernst Zermelo",1870,"1953",1,"mathematical logic"," philosopher","COL",83
"Benjamin Peirce",1800,"1880",0,"Q3968"," astronomer","DEU",80
"Wilhelm Wirtinger",1860,"1945",0,"mathematics"," university teacher","AUT",85
"Jakob Hermann",1670,"1733",0,"mechanics"," university teacher","BEL",63
"György Elekes",1940,"2008",0,"combinatorics"," computer scientist","HUN",68
"Francesco Maria Grimaldi",1610,"1663",0,"physicist"," mathematician","ITA",53
"Deane Montgomery",1900,"1992",1,"topology"," topologist","USA",92
"Pierre-Simon Laplace",1740,"1827",1,"celestial mechanics"," astronomer","FRA",87
"Joseph Diaz Gergonne",1770,"1859",0,"geometry"," philosopher","BOL",89
"John R. Stallings",1930,"2008",1,"group theory"," topologist","USA",78
"Oleg Lupanov",1930,"2006",1,"discrete mathematics"," computer scientist","RUS",76
"Nikolai Smirnov (mathematician)",1900,"1966",1,"probability theory"," statistician","RUS",66
"Harry Rauch",1920,"1979",0,"differential geometry"," university teacher","CAN",59
"Poul Heegaard",1870,"1948",0,"topology"," topologist","DNK",78
"Boris Delaunay",1890,"1980",1,"abstract algebra"," university teacher","RUS",90
"Oskar Anderson",1880,"1960",0,"mathematics"," economist","BLR",80
"Georgy Adelson-Velsky",1920,"2014",0,"mathematics"," computer scientist","ETH",94
"Émile Borel",1870,"1956",1,"probability theory"," politician","FRA",86
"Marina Ratner",1930,"2017",1,"mathematics"," university teacher","RUS",87
"Carl Friedrich Gauss",1770,"1855",1,"number theory"," geophysicist","AUS",85
"Bertrand Russell",1870,"1970",1,"set theory"," social critic","GBR",100
"Clive Granger",1930,"2009",1,"economics"," statistician","AUS",79
"Nikolai Luzin",1880,"1950",1,"Function theory"," university teacher","RUS",70
"Christian Wiener",1820,"1896",0,"geometry"," university teacher","DEU",76
"René-Louis Baire",1870,"1932",0,"topology"," topologist","CAN",62
"Victor Andreevich Toponogov",1930,"2004",0,"geometry"," university teacher","RUS",74
"William Wallace (mathematician)",1760,"1843",0,"geometry"," civil engineer","AUS",83
"Jacob Wolfowitz",1910,"1981",1,"probability theory"," statistician","USA",71
"Carl Adam Petri",1920,"2010",1,"mathematics"," computer scientist","DEU",90
"Herman Wold",1900,"1992",0,"probability theory"," economist","NOR",92
"Jacques Philippe Marie Binet",1780,"1856",0,"astronomy"," physicist","FRA",76
"René de Saussure",1860,"1943",0,"mathematics"," interlinguist","CHE",83
"Vincenzo Riccati",1700,"1775",0,"mathematics"," physicist","ITA",75
"David George Kendall",1910,"2007",1,"probability theory"," statistician","CAN",97
"Nikolai Aleksandrovich Shanin",1910,"2011",0,"topology"," university teacher","RUS",101
"László Kalmár",1900,"1976",1,"mathematical logic"," computer scientist","HUN",76
"Eugene Lukacs",1900,"1987",0,"probability theory"," statistician","HUN",87
"Edwin E. Moise",1910,"1998",1,"geometry"," topologist","BRB",88
"Martin Eichler",1910,"1992",0,"number theory"," university teacher","DEU",82
"Max Dehn",1870,"1952",0,"group theory"," historian of mathematics","DEU",82
"Andrew M. Gleason",1920,"2008",0,"mathematical analysis"," university teacher","COL",88
"John Forbes Nash Jr.",1920,"2015",1,"partial differential equation"," economist","USA",95
"Renato Caccioppoli",1900,"1959",0,"mathematical analysis"," university teacher","ITA",59
"Klaus Matthes",1930,"1998",1,"probability theory"," statistician","COL",68
"Piers Bohl",1860,"1921",0,"mathematical analysis"," university teacher","BEL",61
"Waclaw Sierpinski",1880,"1969",1,"number theory"," topologist","JAM",89
"Martin Löb",1920,"2006",0,"mathematical logic"," university teacher","COL",86
"Hans Carl Friedrich von Mangoldt",1850,"1925",0,"number theory"," university teacher","DEU",75
"Benoit Mandelbrot",1920,"2010",1,"fractal"," economist","JAM",90
"Vladimir Smirnov (mathematician)",1880,"1974",1,"complex analysis"," university teacher","RUS",94
"Gaspard Monge",1740,"1818",1,"differential geometry"," politician","FRA",78
"Stanislaw Zaremba (mathematician)",1860,"1942",0,"mathematical analysis"," university teacher","UKR",82
"Siméon Denis Poisson",1780,"1840",1,"mathematical analysis"," astronomer","FRA",60
"Johann Jakob Balmer",1820,"1898",0,"mathematics"," mathematician","CHE",78
"Wu Wenjun",1910,"2017",1,"topology"," historian of mathematics","CHN",107
"Wilhelm Launhardt",1830,"1918",0,"mathematics"," economist","CAN",88
"Charles Jean de la Vallée-Poussin",1860,"1962",1,"number theory"," university teacher","BEL",102
"Giacomo F. Maraldi",1660,"1729",0,"astronomy"," mathematician","ITA",69
"Gerhard Hessenberg",1870,"1925",0,"geometry"," university teacher","DEU",55
"Peter Hilton",1920,"2010",0,"topology"," topologist","BLZ",90
"Atle Selberg",1910,"2007",1,"number theory"," university teacher","NOR",97
"Farkas Bolyai",1770,"1856",0,"mathematics"," poet","ERI",86
"Roland Dobrushin",1920,"1995",0,"probability theory"," physicist","RUS",75
"Nesmith Ankeny",1920,"1993",0,"number theory"," university teacher","AUS",73
"Leonid Khachiyan",1950,"2005",1,"applied mathematics"," computer scientist","RUS",55
"Adolph P. Yushkevich",1900,"1993",1,"history of mathematics"," historian of mathematics","UKR",93
"Herbert A. Simon",1910,"2001",1,"economics"," psychologist","USA",91
"Alexander Abrosimov",1940,"2011",0,"complex analysis"," educator","ETH",71
"Giovanni Antonio Magini",1550,"1617",0,"cartography"," mathematician","BGD",67
"Garrett Birkhoff",1910,"1996",1,"Q3968"," university teacher","CAN",86
"Allyn Abbott Young",1870,"1929",0,"economics"," statistician","GBR",59
"Henry Mann",1900,"2000",1,"group theory"," statistician","AUT",100
"Lorenzo Respighi",1820,"1889",0,"astronomy"," astronomer","ITA",69
"Reinhold Baer",1900,"1979",0,"Q3968"," university teacher","COL",79
"Duncan Sommerville",1870,"1934",1,"geometry"," astronomer","IND",64
"Heini Halberstam",1920,"2014",0,"number theory"," university teacher","BEL",94
"Armand Borel",1920,"2003",1,"topology"," topologist","CHE",83
"Augustin-Louis Cauchy",1770,"1857",1,"mathematical analysis"," engineer","CAN",87
"Karl Prachar",1920,"1994",0,"number theory"," university teacher","AUT",74
"Julius Weisbach",1800,"1871",0,"hydraulics"," engineer","DEU",71
"Naum Meiman",1910,"2001",1,"physics"," physicist","BLR",91
"Paul Émile Appell",1850,"1930",1,"mathematical analysis"," university teacher","BEL",80
"John William Theodore Youngs",1910,"1970",1,"graph theory"," topologist","BGD",60
"Andrey Markov",1850,"1922",1,"probability theory"," statistician","RUS",72
"Ronald Fisher",1890,"1962",1,"statistics"," geneticist","BLZ",72
"Alfred Korzybski",1870,"1950",0,"engineering"," linguist","JAM",80
"Ernst G. Straus",1920,"1983",0,"combinatorics"," university teacher","DEU",63
"Luigi Bodio",1840,"1920",0,"statistics"," statistician","AFG",80
"George Pólya",1880,"1985",0,"mathematical analysis"," statistician","HUN",105
"Enrico Betti",1820,"1892",0,"topology"," topologist","ITA",72
"Richard Dedekind",1830,"1916",0,"Q3968"," philosopher","AUS",86
"Ludwig Berwald",1880,"1942",0,"differential geometry"," university teacher","CZE",62
"Karl Menger",1900,"1985",1,"mathematics"," philosopher","AUT",85
"Robin Gandy",1910,"1995",0,"mathematical logic"," philosopher","GBR",85
"Leonard Jimmie Savage",1910,"1971",1,"mathematics"," statistician","USA",61
"Vladimir Markovich Entov",1930,"2008",0,"applied mathematics"," physicist","RUS",78
"William Thurston",1940,"2012",1,"topology"," topologist","ARG",72
"Vasili Yakovlevich Zinger",1830,"1907",0,"mathematics"," botanist","RUS",77
"Richard Courant",1880,"1972",1,"mathematical analysis"," university teacher","POL",92
"Mario Pieri",1860,"1913",0,"geometry"," philosopher","ITA",53
"Fokko du Cloux",1950,"2006",0,"computer science"," computer scientist","DEU",56
"Ralph P. Boas Jr.",1910,"1992",1,"mathematical analysis"," university teacher","AUS",82
"Robert Woodhouse",1770,"1827",1,"mathematical analysis"," university teacher","CAN",57
"John Hasbrouck Van Vleck",1890,"1980",1,"physics"," physicist","AUS",90
"Samuel Karlin",1920,"2007",1,"functional analysis"," statistician","USA",87
"Hendrik Kloosterman",1900,"1968",0,"number theory"," university teacher","NLD",68
"Alfréd Rényi",1920,"1970",1,"probability theory"," university teacher","HUN",50
"Pierre Fatou",1870,"1929",1,"Complex dynamics"," astronomer","FRA",59
"Jean le Rond dAlembert",1710,"1783",1,"mathematics"," mathematician","CAN",73
"Blaise Pascal",1620,"1662",0,"probability theory"," philosopher","FRA",42
"Ivan Petrovsky",1900,"1973",1,"partial differential equation"," university teacher","RUS",73
"Jurij Vega",1750,"1802",0,"computational mathematics"," physicist","SVN",52
"Jacques Hadamard",1860,"1963",1,"partial differential equation"," professor","ARG",103
"Vladimir Arnold",1930,"2010",1,"mathematical analysis"," topologist","UKR",80
"Georges Reeb",1920,"1993",0,"mathematics"," university teacher","FRA",73
"Galileo Galilei",1560,"1642",0,"astronomy"," philosopher","COL",82
"Thomas Fincke",1560,"1656",0,"trigonometry"," physicist","DEU",96
"Pelageya Polubarinova-Kochina",1890,"1999",1,"mechanics"," historian of mathematics","KAZ",109
"Dmitrii Menshov",1890,"1988",1,"mathematical analysis"," university teacher","RUS",98
"David A. Huffman",1920,"1999",1,"information theory"," university teacher","AUS",79
"Paul Lévy (mathematician)",1880,"1971",1,"probability theory"," engineer","CAN",91
"Friedrich Hirzebruch",1920,"2012",1,"mathematics"," university teacher","DEU",92
"Anatoliy Skorokhod",1930,"2011",1,"probability theory"," university teacher","BGR",81
"W. R. (Red) Alford",1930,"2003",0,"number theory"," lawyer","CHN",73
"Hermann Minkowski",1860,"1909",1,"geometry"," mathematician","LTU",49
"Edwin Hewitt",1920,"1999",1,"mathematical analysis"," university teacher","USA",79
"Paul Lorenzen",1910,"1994",1,"proof theory"," philosopher","BEL",84
"Israel Nathan Herstein",1920,"1988",1,"Q3968"," university teacher","POL",68
"Hermann Rothe",1880,"1923",0,"group theory"," university teacher","AUT",43
"Herbert Busemann",1900,"1994",0,"differential geometry"," university teacher","COL",94
"Harry Bateman",1880,"1946",1,"mathematics"," university teacher","BOL",66
"Robert Giffen",1830,"1910",1,"statistics"," statistician","GBR",80
"Ernst Schröder",1840,"1902",0,"mathematics"," university teacher","DEU",62
"Paul A. Catlin",1940,"1995",0,"graph theory"," university teacher","CAN",55
"Carlo Emilio Bonferroni",1890,"1960",0,"probability theory"," statistician","ITA",70
"Charles Spearman",1860,"1945",1,"psychology"," statistician","BLZ",85
"Martin Gardner",1910,"2010",0,"mathematics"," writer","PAK",100
"Hans Zassenhaus",1910,"1991",0,"group theory"," university teacher","CHE",81
"Nikolay Mitrofanovich Krylov",1870,"1955",1,"mechanics"," physicist","RUS",85
"Federico Commandino",1500,"1575",0,"mathematics"," historian of mathematics","ITA",75
"Zdenek Frolík",1930,"1989",0,"topology"," topologist","CZE",59
"Detlef Gromoll",1930,"2008",0,"differential geometry"," university teacher","COL",78
"Gabriel Mouton",1610,"1694",0,"mathematics"," mathematician","ATG",84
"Eric Harold Neville",1880,"1961",0,"mathematics"," university teacher","BLZ",81
"Traian Lalescu",1880,"1929",0,"mathematical analysis"," university teacher","ROU",49
"Pietro Mengoli",1620,"1686",0,"mathematics"," university teacher","ITA",66
"William Feller",1900,"1970",1,"probability theory"," university teacher","BIH",70
"Nikoloz Muskhelishvili",1890,"1976",1,"integral equation"," scientist","GEO",86
"François Arago",1780,"1853",1,"physics"," mathematician","FRA",73
"Johannes van der Corput",1890,"1975",0,"number theory"," university teacher","NLD",85
"Jean-Christophe Yoccoz",1950,"2016",1,"mathematics"," professor","CAN",66
"Louis Bachelier",1870,"1946",0,"probability theory"," economist","CAN",76
"Vyacheslav Ivanovich Lebedev",1930,"2010",1,"computational mathematics"," university teacher","RUS",80
"Theodor Vahlen",1860,"1945",0,"number theory"," politician","AUT",85
"Heinrich Franz Friedrich Tietze",1880,"1964",1,"group theory"," university teacher","AUT",84
"Henry Thomas Colebrooke",1760,"1837",1,"Sanskrit"," orientalist","BLZ",77
"Colin Maclaurin",1690,"1746",1,"mathematics"," physicist","BLZ",56
"Alfred Brauer",1890,"1985",0,"number theory"," university teacher","DEU",95
"Gösta Mittag-Leffler",1840,"1927",0,"mathematics"," university teacher","SWE",87
"W. V. D. Hodge",1900,"1975",1,"mathematics"," astronomer","GBR",75
"James Hopwood Jeans",1870,"1946",1,"physics"," physicist","GBR",76
"Satyendra Nath Bose",1890,"1974",1,"mathematical physics"," mathematician","IND",84
"Willem de Sitter",1870,"1934",1,"astronomy"," mathematician","NLD",64
"Ismaël Bullialdus",1600,"1694",1,"astronomy"," mathematician","CHN",94
"Ellice Horsburgh",1870,"1935",1,"numismatics"," engineer","AUS",65
"François Thureau-Dangin",1870,"1944",0,"Oriental studies"," archaeologist","CAN",74
"Rajeev Motwani",1960,"2009",1,"informatics"," computer scientist","IND",49
"Akif Jafar Hajiyev",1930,"2015",0,"mathematical analysis"," educator","AZE",85
"Monroe D. Donsker",1920,"1991",0,"probability theory"," university teacher","AUS",71
"Edwin Thompson Jaynes",1920,"1998",0,"statistical physics"," statistician","AUS",78
"John Alan Robinson",1930,"2016",1,"mathematics"," computer scientist","BRB",86
"Gabriel Lamé",1790,"1870",1,"mathematics"," physicist","FRA",80
"Peter Ludwig Mejdell Sylow",1830,"1918",1,"group theory"," professor","DNK",88
"Nicolaus I Bernoulli",1680,"1759",1,"probability theory"," university teacher","BEL",79
"Denis Sargan",1920,"1996",0,"economics"," statistician","AUS",76
"George Green (mathematician)",1790,"1841",0,"mathematical analysis"," physicist","CAN",51
"Paul Gustav Heinrich Bachmann",1830,"1920",0,"group theory"," historian of mathematics","COL",90
"Henri Brocard",1840,"1922",1,"geometry"," speleologist","FRA",82
"Alfred Horn",1910,"2001",0,"lattice"," university teacher","USA",91
"Olga Ladyzhenskaya",1920,"2004",1,"mathematical analysis"," university teacher","RUS",84
"Heiner Zieschang",1930,"2004",1,"topology"," topologist","BEL",74
"Joseph Liouville",1800,"1882",1,"mathematical analysis"," politician","FRA",82
"Joseph L. Doob",1910,"2004",1,"probability theory"," university teacher","COL",94
"Johann Benedict Listing",1800,"1882",0,"topology"," topologist","DEU",82
"Alexander Friedmann",1880,"1925",1,"theoretical physics"," physicist","RUS",45
"Vladimir Andrunakievich",1910,"1997",1,"Q3968"," educator","RUS",87
"Andrzej Grzegorczyk",1920,"2014",0,"mathematical logic"," university teacher","JAM",94
"Nicolas Léonard Sadi Carnot",1790,"1832",0,"thermodynamics"," physicist","CAN",42
"Lorenzo Mascheroni",1750,"1800",0,"geometry"," writer","ITA",50
"Arnold S. Shapiro",1920,"1962",0,"topology"," topologist","BOL",42
"Paul Epstein",1870,"1939",0,"number theory"," university teacher","DEU",69
"Sylvestre François Lacroix",1760,"1843",0,"mathematics"," professor","CAN",83
"Aizik Volpert",1920,"2006",0,"mathematical analysis"," engineer","UKR",86
"Erika Pannwitz",1900,"1975",0,"topology"," topologist","DEU",75
"Alexander Ostrowski",1890,"1986",0,"Q3968"," university teacher","RUS",96
"Baha<U+02BE> al-din al-<U+02BF>Amili",1540,"1622",0,"mathematician"," scientist","LBN",82
"Raphael M. Robinson",1910,"1995",0,"set theory"," philosopher","USA",85
"Stephen Cole Kleene",1900,"1994",1,"theoretical computer science"," computer scientist","GBR",94
"Leonard Eugene Dickson",1870,"1954",1,"Q3968"," historian of mathematics","PNG",84
"Hanna Neumann",1910,"1971",0,"group theory"," scientist","COL",61
"Richard Lashof",1920,"2010",0,"topology"," topologist","BRA",90
"Paolo Ruffini",1760,"1822",0,"Q3968"," physician","ITA",62
"Jurjen Ferdinand Koksma",1900,"1964",0,"number theory"," university teacher","NLD",64
"Hermann Hankel",1830,"1873",0,"mathematical analysis"," historian of mathematics","BEL",43
"Sarvadaman Chowla",1900,"1995",1,"number theory"," university teacher","BLZ",95
"Paul-André Meyer",1930,"2003",1,"probability theory"," university teacher","FRA",73
"Alexander Gelfond",1900,"1968",1,"number theory"," university teacher","RUS",68
"James Clerk Maxwell",1830,"1879",1,"physics"," mathematician","GBR",49
"Ruan Yuan",1760,"1849",0,"chinese philosophy"," historian of mathematics","CHN",89
"Jerzy Neyman",1890,"1981",1,"mathematical analysis"," philosopher","IDN",91
"Camille Jordan",1830,"1922",1,"group theory"," engineer","ATG",92
"Abraham Adrian Albert",1900,"1972",1,"Q3968"," university teacher","BLZ",72
"Tatyana Afanasyeva",1870,"1964",0,"probability theory"," physicist","RUS",94
"Carl Ludwig Siegel",1890,"1981",1,"number theory"," university teacher","COL",91
"Paul Finsler",1890,"1970",0,"differential geometry"," university teacher","DEU",80
"Józef Maria Hoene-Wronski",1770,"1853",0,"mathematics"," philosopher","POL",83
"Niels Henrik Abel",1800,"1829",1,"group theory"," university teacher","NOR",29
"Kiyosi Itô",1910,"2008",1,"probability theory"," university teacher","JPN",98
"Ernesto Cesàro",1850,"1906",0,"differential geometry"," university teacher","ITA",56
"Mary Ellen Rudin",1920,"2013",0,"topology"," topologist","USA",93
"Kiiti Morita",1910,"1995",0,"Q3968"," topologist","JPN",85
"Jagdish Chandra Bose",1850,"1937",1,"physics"," botanist","IND",87
"Antoni Zygmund",1900,"1992",1,"mathematical analysis"," university teacher","JAM",92
"Girard Desargues",1590,"1661",0,"geometry"," architect","ATG",71
"Erhard Schmidt",1870,"1959",1,"functional analysis"," university teacher","EST",89
"Ferdinand Georg Frobenius",1840,"1917",0,"Q3968"," university teacher","DEU",77
"Horst Schubert",1910,"2001",0,"topology"," topologist","DEU",91
"Joseph Bertrand",1820,"1900",1,"probability theory"," economist","CAN",80
"Ferdinand Minding",1800,"1885",1,"differential geometry"," university teacher","POL",85
"Richard Brauer",1900,"1977",1,"group theory"," university teacher","DEU",77
"Patrick Suppes",1920,"2014",1,"set theory"," philosopher","PAK",94
"José Luis Massera",1910,"2002",1,"mathematical analysis"," politician","AUS",92
"Ernest Barnes",1870,"1953",1,"mathematics"," priest","GBR",83
"Karl F. Sundman",1870,"1949",0,"mathematics"," astronomer","FIN",79
"André Weil",1900,"1998",1,"algebraic geometry"," historian of mathematics","CAN",98
"Hans Heilbronn",1900,"1975",1,"number theory"," university teacher","COL",75
"Grigore Moisil",1900,"1973",1,"mathematical logic"," computer scientist","ROU",73
"Paul Bernays",1880,"1977",0,"mathematical logic"," philosopher","BLZ",97
"Alfred Pringsheim",1850,"1941",0,"mathematics"," university teacher","LTU",91
"Vito Volterra",1860,"1940",1,"mathematical analysis"," physicist","AUS",80
"Ilya Piatetski-Shapiro",1920,"2009",1,"number theory"," educator","RUS",89
"Shimon Even",1930,"2004",0,"graph theory"," cryptographer","ISR",74
"Yuri Prokhorov",1920,"2013",1,"probability theory"," university teacher","RUS",93
"Joseph Wedderburn",1880,"1948",1,"Q3968"," engineer","GBR",68
"Johann Euler",1730,"1800",1,"mathematics"," astronomer","RUS",70
"Karl Wilhelm Feuerbach",1800,"1834",0,"geometry"," university teacher","DEU",34
"Boris Koyalovich",1860,"1941",0,"probability theory"," chess player","RUS",81
"Lars Gårding",1910,"2014",0,"partial differential equation"," university teacher","SWE",104
"Eugenio Elia Levi",1880,"1917",0,"mathematical analysis"," university teacher","BLR",37
"Ada Lovelace",1810,"1852",0,"computer science"," programmer","BLZ",42
"Pierre Varignon",1650,"1722",1,"mathematical analysis"," Catholic priest","ESP",72
"Yutaka Taniyama",1920,"1958",0,"number theory"," university teacher","IND",38
"Jakow Trachtenberg",1880,"1953",0,"mathematics"," inventor","UKR",73
"Abel Transon",1800,"1876",1,"mathematics"," journalist","ARG",76
"Friedrich Bessel",1780,"1846",1,"mathematics"," mathematician","AUS",66
"Alfred Young",1870,"1940",1,"combinatorics"," parson","GBR",70
"Johan Jensen (mathematician)",1850,"1925",0,"number theory"," engineer","DNK",75
"Kenjiro Shoda",1900,"1977",1,"mathematics"," university teacher","JPN",77
"Pieter Hendrik Schoute",1840,"1913",0,"geometry"," university teacher","NLD",73
"Pavel Alexandrov",1890,"1982",1,"topology"," university teacher","RUS",92
"Horst Sachs",1920,"2016",1,"graph theory"," historian of mathematics","DEU",96
"Kari Karhunen",1910,"1992",0,"probability theory"," statistician","FIN",82
"Adrien-Marie Legendre",1750,"1833",1,"number theory"," university teacher","CAN",83
"Pierre Gabriel",1930,"2015",0,"mathematics"," university teacher","FRA",85
"Robert Richard Anstice",1810,"1853",0,"combinatorics"," cleric","GBR",43
"Louis Poinsot",1770,"1859",1,"analytical mechanics"," physicist","AUS",89
"Karl Weissenberg",1890,"1976",1,"rheology"," physicist","AUT",86
"Jovan Karamata",1900,"1967",0,"mathematical analysis"," university teacher","BIH",67
"Johannes Fallati",1800,"1855",0,"statistician"," statistician","DEU",55
"Jacques Herbrand",1900,"1931",0,"proof theory"," philosopher","CAN",31
"Robert Fricke",1860,"1930",0,"mathematical analysis"," university teacher","DEU",70
"Gabriel Andrew Dirac",1920,"1984",0,"graph theory"," university teacher","HUN",64
"Jérôme Franel",1850,"1939",0,"number theory"," university teacher","CHE",89
"Agner Krarup Erlang",1870,"1929",0,"queueing theory"," engineer","AUS",59
"Cathleen Synge Morawetz",1920,"2017",1,"mathematical analysis"," university teacher","AUS",97
"Kosaku Yosida",1900,"1990",1,"mathematical analysis"," university teacher","JPN",90
"Constantin Carathéodory",1870,"1950",0,"mathematical analysis"," university teacher","COL",80
"Charles Babbage",1790,"1871",1,"mathematics"," computer scientist","BLZ",81
"Georges de Rham",1900,"1990",1,"topology"," topologist","CHE",90
"Henry John Stephen Smith",1820,"1883",1,"number theory"," university teacher","AUS",63
"Wilhelm Klingenberg",1920,"2010",0,"differential geometry"," university teacher","AUT",90
"Édouard Roche",1820,"1883",1,"astronomy"," mathematician","FRA",63
"Nicolas de Malézieu",1650,"1727",0,"Greek studies"," writer","CAN",77
"Anatoli Georgievich Vitushkin",1930,"2004",1,"approximation theory"," computer scientist","RUS",74
"Emil Grosswald",1910,"1989",0,"mathematical analysis"," university teacher","ROU",79
"H. F. Baker",1860,"1956",1,"partial differential equation"," astronomer","AUS",96
"James Waddell Alexander II",1880,"1971",1,"topology"," topologist","USA",91
"Martin Ohm",1790,"1872",0,"mathematics"," university teacher","DEU",82
"Luigi Bianchi",1850,"1928",0,"differential geometry"," university teacher","CHN",78
"Frank P. Ramsey",1900,"1930",0,"combinatorics"," philosopher","AUS",30
"Jakob Rosanes",1840,"1922",0,"algebraic geometry"," chess player","BLR",82
"E. T. Whittaker",1870,"1956",1,"mathematics"," astronomer","AUS",86
"Emanuel Lasker",1860,"1941",1,"Q3968"," chess player","POL",81
"Willebrord Snellius",1580,"1626",0,"mathematics"," mathematician","NLD",46
"Paul Olum",1910,"2001",0,"topology"," topologist","USA",91
"Sophus Lie",1840,"1899",1,"group theory"," university teacher","NOR",59
"Bronislaw Knaster",1890,"1980",0,"topology"," topologist","JAM",90
"Jacobus Golius",1590,"1667",0,"Oriental studies"," university teacher","NLD",77
"Gordon Thomas Whyburn",1900,"1969",1,"topology"," topologist","USA",69
"Eduard Heine",1820,"1881",0,"mathematical analysis"," university teacher","COL",61
"Zoltán Tibor Balogh",1950,"2002",0,"topology"," topologist","HUN",52
"Gerolamo Cardano",1500,"1576",0,"mathematics"," mathematician","COL",76
"Dmitri Egorov",1860,"1931",1,"differential geometry"," university teacher","RUS",71
"William Kingdon Clifford",1840,"1879",1,"Q3968"," philosopher","AUS",39
"Paul Stäckel",1860,"1919",0,"differential geometry"," historian of mathematics","COL",59
"Peter M. Gruber",1940,"2017",1,"geometry"," university teacher","AUT",77
"Émile Lemoine",1840,"1912",1,"geometry"," civil engineer","FRA",72
"Aleksandr Lyapunov",1850,"1918",0,"stability theory"," physicist","RUS",68
"Otto Schilling",1910,"1973",0,"Q3968"," university teacher","DEU",63
"Mstislav Keldysh",1910,"1978",1,"mathematics"," engineer","AFG",68
"Lazarus Fuchs",1830,"1902",1,"complex analysis"," teacher","ITA",72
"Karel deLeeuw",1930,"1978",0,"mathematical analysis"," university teacher","BLZ",48
"Marian Rejewski",1900,"1980",1,"mathematics"," cryptologist","POL",80
"Emmy Noether",1880,"1935",1,"Q3968"," physicist","DEU",55
"Edward Bromhead",1780,"1855",0,"mathematical analysis"," botanist","AUS",75
"Peter Tait (physicist)",1830,"1901",1,"mathematical physics"," physicist","AUS",71
"Lucien Le Cam",1920,"2000",0,"probability theory"," statistician","FRA",80
"Ingram Olkin",1920,"2016",1,"combinatorics"," statistician","USA",96
"Arthur Lyon Bowley",1860,"1957",1,"economics"," statistician","CAN",97
"George David Birkhoff",1880,"1944",0,"topology"," topologist","USA",64
"J. H. van Lint",1930,"2004",1,"combinatorics"," university teacher","IDN",74
"Felice Casorati (mathematician)",1830,"1890",0,"mathematical analysis"," university teacher","COL",60
"Nicholas Metropolis",1910,"1999",1,"physics"," physicist","BLZ",89
"Chris Heyde",1930,"2008",0,"probability theory"," statistician","AUS",78
"Raoul Bott",1920,"2005",1,"geometry"," physicist","HUN",85
"Boris Vladimirovich Gnedenko",1910,"1995",1,"probability theory"," historian of mathematics","RUS",85
"Eberhard Hopf",1900,"1983",1,"topology"," topologist","AUT",83
"Abraham Fraenkel",1890,"1965",1,"set theory"," university teacher","DEU",75
"Hans Hahn (mathematician)",1870,"1934",1,"set theory"," philosopher","AUT",64
"Raoul Bricard",1870,"1943",1,"geometry"," engineer","CAN",73
"Egbert van Kampen",1900,"1942",0,"topology"," topologist","BEL",42
"Elwin Bruno Christoffel",1820,"1900",0,"differential geometry"," physicist","DEU",80
"Grégoire de Saint-Vincent",1580,"1667",0,"geometry"," priest","BEL",87
"Victor Puiseux",1820,"1883",0,"mathematics"," astronomer","FRA",63
"Georg Scheffers",1860,"1945",0,"differential geometry"," university teacher","DEU",85
"Michel Loève",1900,"1979",0,"probability theory"," statistician","AUS",79
"Stanislaw Jaskowski",1900,"1965",0,"logic"," philosopher","JAM",65
"Jean-Étienne Montucla",1720,"1799",0,"history of mathematics"," historian of mathematics","ATG",79
"Leopold Gegenbauer",1840,"1903",0,"mathematics"," university teacher","AUT",63
"Olaus Henrici",1840,"1918",1,"mathematics"," university teacher","DEU",78
"August Adler",1860,"1923",0,"geometry"," astronomer","CZE",63
"Sergei Sobolev",1900,"1989",1,"mathematical physics"," university teacher","RUS",89
"Stefan Mazurkiewicz",1880,"1945",0,"mathematical analysis"," topologist","JAM",65
"Carl Benjamin Boyer",1900,"1976",1,"history of mathematics"," historian of mathematics","USA",76
"John Selfridge",1920,"2010",0,"number theory"," university teacher","USA",90
"Louis J. Mordell",1880,"1972",1,"number theory"," university teacher","BRA",92
"Friedrich Wilhelm Levi",1880,"1966",0,"group theory"," university teacher","FRA",86
"Sergey Mergelyan",1920,"2008",1,"mathematical analysis"," scientist","UKR",88
"Pierre de Fermat",1600,"1665",0,"number theory"," judge","FRA",65
"Giuseppe Vitali",1870,"1932",0,"mathematical analysis"," university teacher","ITA",62
"John Maynard Smith",1920,"2004",1,"evolutionary biology"," theoretical biologist","BLZ",84
"László Rédei",1900,"1980",1,"Q3968"," university teacher","HUN",80
"Boris Levin",1900,"1993",0,"Function theory"," university teacher","UKR",93
"Margherita Piazzola Beloch",1870,"1976",0,"algebraic geometry"," university teacher","ITA",106
"L. E. J. Brouwer",1880,"1966",1,"mathematical analysis"," philosopher","NLD",86
"Ernst Meissel",1820,"1895",0,"number theory"," mathematician","DEU",75
"Kurt Reidemeister",1890,"1971",0,"topology"," topologist","AUS",81
"Samuel Dickstein (mathematician)",1850,"1939",0,"Q3968"," educator","JAM",89
"Vojtech Jarník",1890,"1970",0,"mathematical physics"," educator","CZE",80
"Wassily Hoeffding",1910,"1991",0,"probability theory"," statistician","CAN",81
"Giovanni Battista Amici",1780,"1863",1,"astronomy"," biologist","ITA",83
"George Boole",1810,"1864",1,"mathematical logic"," philosopher","ARG",54
"Martin Kneser",1920,"2004",1,"number theory"," university teacher","DEU",84
"Antoine Augustin Cournot",1800,"1877",0,"economics"," economist","AUT",77
"Richard von Mises",1880,"1953",0,"probability theory"," physicist","UKR",73
"Max Mason",1870,"1961",0,"mathematical analysis"," physicist","CAN",91
"Kazimierz Bartel",1880,"1941",1,"mathematics"," officer","UKR",61
"Willem Jacob van Stockum",1910,"1944",0,"general relativity"," mathematician","NLD",34
"Alexander Esenin-Volpin",1920,"2016",0,"mathematical logic"," poet","RUS",96
"Ruslan Stratonovich",1930,"1997",1,"probability theory"," physicist","RUS",67
"Virgil Snyder",1860,"1950",0,"algebraic geometry"," university teacher","MYS",90
"Kentaro Yano (mathematician)",1910,"1993",0,"differential geometry"," university teacher","JPN",83
"Wladyslaw Orlicz",1900,"1990",0,"functional analysis"," topologist","POL",90
"Boleslav Mlodzeevskii",1850,"1923",0,"differential geometry"," university teacher","RUS",73
"Leonhard Euler",1700,"1783",0,"mathematical analysis"," physicist","BEL",83
"Abdus Salam",1920,"1996",1,"quantum field theory"," university teacher","IND",76
"Corrado Gini",1880,"1965",0,"economics"," statistician","ITA",85
"John Henry Poynting",1850,"1914",1,"physics"," university teacher","BOL",64
"Edward Waring",1730,"1798",1,"number theory"," professor","GBR",68
"Johann Heinrich Lambert",1720,"1777",0,"physics"," astronomer","FRA",57
"Caroline Herschel",1750,"1848",1,"astronomy"," mathematician","CAN",98
"Walther von Dyck",1850,"1934",1,"combinatorics"," university teacher","DEU",84
"André-Marie Ampère",1770,"1836",1,"electromagnetism"," mathematician","ATG",66
"Eugène Charles Catalan",1810,"1894",0,"combinatorics"," university teacher","BEL",84
"Otto Blumenthal",1870,"1944",0,"mathematics"," university teacher","DEU",74
"Hirotugu Akaike",1920,"2009",1,"statistics"," statistician","JPN",89
"Alexandre-Théophile Vandermonde",1730,"1796",0,"Q3968"," chemist","CAN",66
"Jack Kiefer (statistician)",1920,"1981",1,"mathematics"," statistician","COL",61
"George Batchelor",1920,"2000",1,"mechanics"," physicist","AUS",80
"Petr Vopenka",1930,"2015",1,"set theory"," historian of mathematics","CZE",85
"Peter Gavin Hall",1950,"2016",1,"probability theory"," statistician","AUS",66
"Sophie Germain",1770,"1831",1,"number theory"," physicist","CAN",61
"Roger Cotes",1680,"1716",1,"mathematical analysis"," astronomer","GBR",36
"Gilles de Roberval",1600,"1675",0,"mathematics"," mathematician","FRA",75
"Lorenz Leonard Lindelöf",1820,"1908",0,"analytic geometry"," politician","FIN",88
"Pasquale del Pezzo",1850,"1936",0,"algebraic geometry"," politician","COL",86
"John Wilson (mathematician)",1740,"1793",1,"number theory"," judge","GBR",53
"Viggo Brun",1880,"1978",1,"number theory"," historian of mathematics","ESP",98
"Carl Anton Bretschneider",1800,"1878",0,"geometry"," historian of mathematics","AUT",78
"Olga Bondareva",1930,"1991",0,"game theory"," mathematician","RUS",61
"Georg Cantor",1840,"1918",1,"set theory"," philosopher","RUS",78
"Hans-Egon Richert",1920,"1993",0,"number theory"," university teacher","DEU",73
"Hermann Weyl",1880,"1955",1,"differential geometry"," physicist","DEU",75
"Thomas L. Saaty",1920,"2017",0,"queueing theory"," university teacher","AZE",97
"John Venn",1830,"1923",1,"mathematical logic"," philosopher","GBR",93
"Hermann Schwarz",1840,"1921",0,"mathematics"," university teacher","RUS",81
"Friedrich Hartogs",1870,"1943",0,"mathematical analysis"," university teacher","BEL",73
"Conrad Henfling",1640,"1716",0,"number theory"," musicologist","DEU",76
"Ziauddin Ahmad",1870,"1947",1,"differential geometry"," philosopher","IND",77
"Georges Valiron",1880,"1955",1,"mathematical analysis"," university teacher","ATG",75
"Christiaan Huygens",1620,"1695",0,"mathematics"," mathematician","NLD",75
"Roland Fraïssé",1920,"2008",0,"mathematical logic"," philosopher","FRA",88
"Tadashi Nakayama (mathematician)",1910,"1964",0,"Q3968"," university teacher","JPN",54
"Aleksei Pogorelov",1910,"2002",1,"differential geometry"," physicist","RUS",92
"Stanislaw Saks",1890,"1942",0,"mathematical analysis"," university teacher","POL",52
"Paul Tannery",1840,"1904",0,"history of mathematics"," historian of mathematics","FRA",64
"Francis Galton",1820,"1911",1,"probability theory"," explorer","GBR",91
"Dénes Konig",1880,"1944",0,"combinatorics"," university teacher","HUN",64
"Nikolai Günther",1870,"1941",1,"differential equation"," university teacher","RUS",71
"Herbert Robbins",1910,"2001",1,"mathematics"," statistician","CRI",91
"Viktor Wagner",1900,"1981",1,"Q3968"," university teacher","RUS",81
"Alfred Tarski",1900,"1983",1,"logic"," philosopher","JAM",83
"Daniel Kan",1920,"2013",0,"topology"," topologist","COL",93
"Vladimir Abramovich Rokhlin",1910,"1984",0,"algebraic geometry"," topologist","AZE",74
"Andrey Kolmogorov",1900,"1987",1,"probability theory"," computer scientist","RUS",87
"James H. Wilkinson",1910,"1986",1,"numerical linear algebra"," computer scientist","GBR",76
"Paul Ehrenfest",1880,"1933",0,"theoretical physics"," theoretical physicist","AUT",53
"Eugene Dynkin",1920,"2014",1,"Q3968"," university teacher","RUS",94
"Isaak Russman",1930,"2005",0,"mathematical model"," economist","RUS",75
"Thomas Harriot",1560,"1621",0,"Q3968"," explorer","BRB",61
"Victor Glushkov",1920,"1982",1,"Q3968"," computer scientist","RUS",62
"Béla Szokefalvi-Nagy",1910,"1998",1,"mathematical analysis"," university teacher","ROU",88
"Karl Pearson",1850,"1936",1,"mathematical statistics"," historian of mathematics","BLZ",86
"Rudolf Luneburg",1900,"1949",0,"geometry"," physicist","DEU",49
"James Ivory (mathematician)",1760,"1842",1,"mathematics"," astronomer","AUS",82
"Herbert Scarf",1930,"2015",1,"economics"," economist","BRA",85
"William S. Massey",1920,"2017",0,"topology"," topologist","BLZ",97
"Christos Papakyriakopoulos",1910,"1976",1,"topology"," topologist","GRC",66
"D. R. Fulkerson",1920,"1976",0,"combinatorics"," computer scientist","USA",56
"Gheorghe <U+021A>i<U+021B>eica",1870,"1939",0,"differential geometry"," university teacher","ROU",69
"Ferdinand von Lindemann",1850,"1939",1,"number theory"," university teacher","CAN",89
"Jürgen Neukirch",1930,"1997",0,"number theory"," university teacher","DEU",67
"Oswald Veblen",1880,"1960",0,"geometry"," topologist","PNG",80
"Sergey Chaplygin",1860,"1942",1,"mechanics"," physicist","RUS",82
"Josip Plemelj",1870,"1967",1,"mathematics"," university teacher","SVN",97
"George Abram Miller",1860,"1951",0,"group theory"," historian of mathematics","USA",91
"Gunter Wyszecki",1920,"1985",0,"mathematics"," physicist","RUS",65
"Joram Lindenstrauss",1930,"2012",1,"functional analysis"," university teacher","ISR",82
"John Lennard-Jones",1890,"1954",1,"physics"," physicist","GBR",64
"Mark Semenovich Pinsker",1920,"2003",1,"coding theory"," computer scientist","RUS",83
"Mark Kac",1910,"1984",1,"probability theory"," university teacher","POL",74
"Kurt Schütte",1900,"1998",0,"mathematical logic"," university teacher","DEU",98
"Nicolaus II Bernoulli",1690,"1726",0,"mathematical analysis"," university teacher","BEL",36
"Thorvald N. Thiele",1830,"1910",0,"mathematics"," astronomer","DNK",80
"Philippe Flajolet",1940,"2011",1,"computer science"," engineer","ATG",71
"Giuseppe Peano",1850,"1932",0,"interlinguistics"," philosopher","ITA",82
"Nicholas Mercator",1620,"1687",0,"mathematics"," astronomer","DEU",67
"Andreas Cellarius",1590,"1665",0,"astronomy"," mathematician","DEU",75
"Harold Scott MacDonald Coxeter",1900,"2003",1,"geometry"," university teacher","BLZ",103
"John von Neumann",1900,"1957",1,"functional analysis"," computer scientist","HUN",57
"Torsten Carleman",1890,"1949",1,"mathematical analysis"," university teacher","SWE",59
"David Gilbarg",1910,"2001",0,"partial differential equation"," university teacher","BOL",91
"Alfredo Capelli",1850,"1910",0,"mathematics"," university teacher","AFG",60
"Giuseppe Battaglini",1820,"1894",0,"geometry"," university teacher","ITA",74
"Hans Riesel",1920,"2014",0,"number theory"," university teacher","SWE",94
"Marino Ghetaldi",1560,"1626",0,"mathematics"," physicist","HRV",66
"Theodor von Oppolzer",1840,"1886",0,"astronomy"," astronomer","CZE",46
"Philipp von Jolly",1800,"1884",0,"physics"," physicist","DEU",84
"Johann Friedrich Pfaff",1760,"1825",0,"mathematical analysis"," astronomer","DEU",65
"Hans Freudenthal",1900,"1990",1,"topology"," historian of mathematics","DEU",90
"Ludvig Faddeev",1930,"2017",1,"mathematical physics"," physicist","RUS",87
"Émilie du Châtelet",1700,"1749",0,"mathematician"," physicist","CAN",49
"James Earl Baumgartner",1940,"2011",0,"mathematical logic"," philosopher","USA",71
"Valery Senderov",1940,"2014",0,"functional analysis"," human rights activist","RUS",74
"Boris Trakhtenbrot",1920,"2016",1,"mathematical logic"," computer scientist","MDA",96
"Danilo Blanuša",1900,"1987",0,"mathematics"," physicist","BIH",87
"Emanuel Sperner",1900,"1980",0,"combinatorics"," university teacher","POL",80
"Pál Turán",1910,"1976",1,"combinatorics"," university teacher","HUN",66
"Øystein Ore",1890,"1968",1,"combinatorics"," historian of mathematics","DNK",78
"Nina Bari",1900,"1961",0,"mathematical analysis"," university teacher","RUS",61
"Siegfried Gottwald",1940,"2015",1,"mathematical logic"," historian of mathematics","AUT",75
"Irénée-Jules Bienaymé",1790,"1878",0,"statistics"," university teacher","CAN",88
"Oscar Zariski",1890,"1986",1,"algebraic geometry"," scientist","BLR",96
"John Cocke",1920,"2002",1,"informatics"," computer scientist","HTI",82
"Abraham H. Taub",1910,"1999",1,"differential geometry"," physicist","BLZ",89
"Albert Turner Bharucha-Reid",1920,"1985",0,"probability theory"," statistician","AUS",65
"Bernhard Riemann",1820,"1866",0,"differential geometry"," physicist","DEU",46
"Evert Willem Beth",1900,"1964",0,"mathematical logic"," philosopher","NLD",64
"Ivan Vidav",1910,"2015",1,"mathematics"," university teacher","COL",105
"Laurent Schwartz",1910,"2002",1,"mathematics"," university teacher","CAN",92
"Alfred Russel Wallace",1820,"1913",1,"geometry"," biologist","CAN",93
"Alexander Alexandrovich Chuprov",1870,"1926",0,"statistics"," university teacher","RUS",56
"G. H. Hardy",1870,"1947",1,"mathematical analysis"," scientist","GBR",77
"Paul Cohen",1930,"2007",1,"set theory"," logician","CAN",77
"Gian-Carlo Rota",1930,"1999",0,"combinatorics"," philosopher","ITA",69
"Aldo Andreotti",1920,"1980",0,"partial differential equation"," university teacher","HTI",60
"Gu Chaohao",1920,"2012",1,"mathematics"," faculty","CHN",92
"Sumner Byron Myers",1910,"1955",0,"topology"," topologist","BOL",45
"Edsger W. Dijkstra",1930,"2002",1,"informatics"," physicist","NLD",72
"Kazimierz Kuratowski",1890,"1980",0,"topology"," philosopher","JAM",90
"Joseph-Louis Lagrange",1730,"1813",1,"mathematical analysis"," astronomer","BLR",83
"François Viète",1540,"1603",0,"Q3968"," cryptographer","FRA",63
"Johann Christian Martin Bartels",1760,"1836",0,"differential geometry"," educator","AUS",76
"Samuel Eilenberg",1910,"1998",1,"topology"," topologist","JAM",88
"Alan Turing",1910,"1954",1,"cryptanalysis"," mathematician","GBR",44
"Erik Ivar Fredholm",1860,"1927",1,"integral equation"," university teacher","SWE",67
"Henri Cartan",1900,"2008",1,"mathematical analysis"," university teacher","BOL",108
"Luther P. Eisenhart",1870,"1965",0,"differential geometry"," university teacher","AUS",95
"Mark Krein",1900,"1989",1,"functional analysis"," university teacher","RUS",89
"Karl Rohn",1850,"1920",0,"geometry"," university teacher","DEU",70
"Ott-Heinrich Keller",1900,"1990",1,"geometry"," university teacher","DEU",90
"Valentin Turchin",1930,"2010",0,"physics"," human rights activist","BLR",80
"Robert Phelps",1920,"2013",0,"functional analysis"," university teacher","BOL",93
"George Gallup",1900,"1984",0,"political science"," sociologist","USA",84
"Tosio Kato",1910,"1999",0,"partial differential equation"," university teacher","COD",89
"Arnold Walfisz",1890,"1962",0,"number theory"," university teacher","JAM",72
"Philipp Furtwängler",1860,"1940",0,"number theory"," university teacher","DEU",80
"George Kempf",1940,"2002",0,"algebraic geometry"," university teacher","HTI",62
"Carl Størmer",1870,"1957",1,"number theory"," physicist","NOR",87
"Andreas von Ettingshausen",1790,"1878",0,"mathematics"," physicist","AUS",88
"Pierre Samuel",1920,"2009",0,"algebraic geometry"," scientist","CAN",89
"Jacques Charles François Sturm",1800,"1855",1,"mathematical physics"," physicist","CHE",55
"Kenneth Appel",1930,"2013",0,"graph theory"," university teacher","AUS",83
"Ulisse Dini",1840,"1918",0,"mathematics"," politician","COL",78
"Boris Galerkin",1870,"1945",1,"mechanics"," engineer","BLR",75
"Erich Kähler",1900,"2000",0,"algebraic geometry"," university teacher","DEU",100
"Bartel Leendert van der Waerden",1900,"1996",1,"Q3968"," university teacher","COL",96
"Eugenio Beltrami",1830,"1900",0,"differential geometry"," university teacher","CAN",70
"Gilbert Hunt",1910,"2008",0,"probability theory"," mathematician","ARG",98
"George W. Whitehead",1910,"2004",1,"topology"," topologist","USA",94
"Oskar Bolza",1850,"1942",0,"geometry"," university teacher","LTU",92
"Patrick Billingsley",1920,"2011",0,"probability theory"," actor","USA",91
"James Joseph Sylvester",1810,"1897",1,"Q3968"," actuary","BLZ",87
"Robert Frucht",1900,"1997",0,"graph theory"," university teacher","COL",97
"Lev Gutenmaher",1900,"1981",1,"numerical analysis"," computer scientist","UKR",81
"Abraham Gotthelf Kästner",1710,"1800",1,"mathematics"," writer","DEU",90
"Mikhail Lavrentyev",1900,"1980",1,"calculus of variations"," physicist","AFG",80
"Jeremiah Horrocks",1610,"1641",0,"astronomy"," mathematician","AUS",31
"Marcel Berger",1920,"2016",1,"geometry"," university teacher","CAN",96
"Bernard Bolzano",1780,"1848",0,"mathematical analysis"," logician","CZE",68
"Ernest Julius Wilczynski",1870,"1932",0,"differential geometry"," university teacher","DEU",62
"Chung Kai-lai",1910,"2009",1,"probability theory"," statistician","CHN",99
"Taqi ad-Din Muhammad ibn Maruf",1520,"1585",0,"astronomy"," astronomer","SYR",65
"J. H. C. Whitehead",1900,"1960",1,"topology"," topologist","IND",60
"Jacob Bernoulli",1650,"1705",0,"probability theory"," physicist","BEL",55
"György Hajós",1910,"1972",1,"Q3968"," university teacher","HUN",62
"Boris Berezovsky (businessman)",1940,"2013",1,"mathematics"," mathematician","RUS",73
"Alice T. Schafer",1910,"2009",0,"topology"," topologist","AUS",99
"Nicolai A. Vasiliev",1880,"1940",0,"logic"," philosopher","AFG",60
"Marquis de Condorcet",1740,"1794",0,"mathematics"," mathematician","FRA",54
"Thomas Bayes",1700,"1761",1,"probability theory"," statistician","BLZ",61
"Ernest de Jonquières",1820,"1901",1,"geometry"," navy officer","FRA",81
"Florian Cajori",1850,"1930",0,"history of mathematics"," historian of mathematics","CHE",80
"K. G. Ramanathan",1920,"1992",1,"number theory"," university teacher","IND",72
"Alexey Lyapunov",1910,"1973",1,"cybernetics"," computer scientist","RUS",63
"Giovanni Domenico Cassini",1620,"1712",1,"astronomy"," geodesist","ITA",92
"Israel Gelfand",1910,"2009",1,"mathematical analysis"," biologist","UKR",99
"Samuel Earnshaw",1800,"1888",0,"physics"," physicist","AUS",88
"Anders Johan Lexell",1740,"1784",0,"astronomy"," mathematician","FIN",44
"Karl Seebach",1910,"2007",0,"mathematics"," university teacher","DEU",97
"Simon Antoine Jean LHuilier",1750,"1840",1,"mathematics"," university teacher","CHE",90
"Robert Lawson Vaught",1920,"2002",1,"model theory"," university teacher","ESP",82
"William Philip Hiern",1830,"1925",1,"botany"," botanist","AUS",95
"Johann III Bernoulli",1740,"1807",0,"mathematics"," astronomer","BEL",67
"Thomas Kirkman",1800,"1895",1,"combinatorics"," topologist","AUS",95
"Federigo Enriques",1870,"1946",0,"algebraic geometry"," historian of mathematics","ITA",76
"Francesco Brioschi",1820,"1897",1,"mathematics"," university teacher","AFG",77
"George Kingsley Zipf",1900,"1950",1,"linguistics"," statistician","BHS",50
"Karl Georg Christian von Staudt",1790,"1867",0,"geometry"," university teacher","DEU",77
"Cyparissos Stephanos",1850,"1917",0,"algebra"," university teacher","GBR",67
"Georgios Remoundos",1870,"1928",0,"mathematics"," mathematician","GRC",58
"Wilhelm Magnus",1900,"1990",1,"group theory"," university teacher","COL",90
"Alfred van der Poorten",1940,"2010",0,"number theory"," university teacher","COL",70
"Mary Somerville",1780,"1872",1,"popular science"," linguist","GBR",92
"Maurice René Fréchet",1870,"1973",1,"mathematical analysis"," Esperantist","FRA",103
"August Leopold Crelle",1780,"1855",0,"mathematics"," engineer","DEU",75
"Karol Borsuk",1900,"1982",0,"topology"," topologist","JAM",82
"Paul Cohn",1920,"2006",1,"Q3968"," university teacher","DEU",86
"Norman Steenrod",1910,"1971",1,"topology"," topologist","CAN",61
"W. T. Tutte",1910,"2002",1,"combinatorics"," university teacher","AUS",92
"Adolf Lindenbaum",1900,"1941",0,"set theory"," philosopher","JAM",41
"Subrahmanyan Chandrasekhar",1910,"1995",1,"astrophysics"," physicist","CMR",85
"Thomas Bartholin",1610,"1680",0,"medicine"," theologian","DNK",70
"Robert Steinberg",1920,"2014",0,"group theory"," scientist","MDA",94
"Andrey Nikolayevich Tikhonov",1900,"1993",1,"topology"," topologist","ARM",93
"Hellmuth Kneser",1890,"1973",0,"group theory"," topologist","EST",83
"Edmund Hlawka",1910,"2009",1,"number theory"," university teacher","AUT",99
"Edward Charles Titchmarsh",1890,"1963",1,"mathematical analysis"," university teacher","AUS",73
"Gerhard Ringel",1910,"2008",0,"graph theory"," university teacher","AUT",98
"Georges-Louis Leclerc, Comte de Buffon",1700,"1788",1,"biology"," volcanologist","FRA",88
"Meyer Bockstein",1910,"1990",0,"topology"," topologist","RUS",80
"Arthur Cayley",1820,"1895",1,"graph theory"," lawyer","CAN",75
"Otto E. Neugebauer",1890,"1990",1,"mathematics"," astronomer","AUT",100
"Georg Alexander Pick",1850,"1942",0,"mathematics"," educator","AUT",92
"William Oughtred",1570,"1660",0,"mathematics"," inventor","AUS",90
"Karl Weierstrass",1810,"1897",1,"mathematical analysis"," teacher","DEU",87
"Johannes de Groot",1910,"1972",0,"topology"," topologist","DEU",62
"Marvin Knopp",1930,"2011",0,"mathematical analysis"," university teacher","BLZ",81
"Arthur Schuster",1850,"1934",1,"seismology"," statistician","DEU",84
"Mkhitar Djrbashian",1910,"1994",1,"Function theory"," contributing editor","ARM",84
"Hugh Everett III",1930,"1982",0,"Q944"," physicist","ARG",52
"John Playfair",1740,"1819",1,"mathematics"," geologist","AUS",79
"Richard Crandall",1940,"2012",0,"number theory"," engineer","USA",72
"Johannes Kepler",1570,"1630",0,"optics"," astrologer","DEU",60
"Grigorii Fichtenholz",1880,"1959",1,"calculus"," university teacher","UKR",79
"Douglas Hartree",1890,"1958",1,"theoretical physics"," physicist","AUS",68
"Walter Rudin",1920,"2010",0,"mathematical analysis"," university teacher","AUT",90
"Luis Santaló",1910,"2001",1,"differential geometry"," university teacher","ESP",91
"Shaun Wylie",1910,"2009",0,"topology"," topologist","BRB",99
"Rudolf E. Kálmán",1930,"2016",1,"control theory"," engineer","HUN",86
"Mikhail Postnikov",1920,"2004",1,"topology"," topologist","RUS",84
"Simion Stoilow",1880,"1961",0,"mathematical analysis"," diplomat","ROU",81
"Ralph Faudree",1930,"2015",1,"combinatorics"," university teacher","BRB",85
"Johann Friedrich Hennert",1730,"1813",0,"mathematical analysis"," astronomer","COL",83
"Igor Shafarevich",1920,"2017",1,"algebraic geometry"," human rights activist","UKR",97
"Francis Dominic Murnaghan (mathematician)",1890,"1976",0,"group theory"," university teacher","GBR",86
"Radha Laha",1930,"1999",0,"probability theory"," statistician","BLZ",69
"Gaetano Fichera",1920,"1996",1,"mathematical analysis"," historian of mathematics","ITA",76
"Willard Van Orman Quine",1900,"2000",1,"model theory"," analytic philosopher","USA",100
"Pavel Urysohn",1890,"1924",0,"topology"," topologist","UKR",34
"Étienne Laspeyres",1830,"1913",0,"statistics"," statistician","BEL",83
"Shreeram Shankar Abhyankar",1930,"2012",0,"algebraic geometry"," university teacher","IND",82
"Errett Bishop",1920,"1983",0,"mathematical analysis"," university teacher","ARG",63
"Max August Zorn",1900,"1993",0,"Q3968"," university teacher","DEU",93
"Adam Olearius",1600,"1671",0,"geography"," linguist","DEU",71
"Max Newman",1890,"1984",1,"mathematics"," mathematician","BLZ",94
"Richard Rado",1900,"1989",1,"combinatorics"," university teacher","COL",89
"Wolfgang Heinrich Johannes Fuchs",1910,"1997",1,"mathematical analysis"," university teacher","DEU",87
"Leopold Vietoris",1890,"2002",1,"topology"," topologist","AUT",112
"Clarence Raymond Adams",1890,"1965",0,"mathematical analysis"," university teacher","USA",75
"Giambattista Benedetti",1530,"1590",0,"mechanics"," physicist","CAN",60
"John Napier",1550,"1617",0,"mathematics"," mathematician","GBR",67
"George Dantzig",1910,"2005",1,"mathematics"," computer scientist","AUS",95
"Shimshon Amitsur",1920,"1994",1,"Q3968"," educator","BOL",74
"Jacques-Louis Lions",1920,"2001",1,"mathematical analysis"," professor","AUT",81
"Kikuchi Dairoku",1850,"1917",1,"mathematics"," university teacher","IDN",67
"Nikolaus Hofreiter",1900,"1990",1,"number theory"," university teacher","AUT",90
"Nathaniel Bliss",1700,"1764",1,"astronomy"," astronomer","GBR",64
"Sergei Natanovich Bernstein",1880,"1968",1,"mathematical analysis"," university teacher","UKR",88
"Paul Sophus Epstein",1880,"1966",0,"theoretical physics"," physicist","JAM",86
"Sofia Kovalevskaya",1850,"1891",1,"mathematics"," physicist","RUS",41
"Robert Lee Moore",1880,"1974",0,"topology"," topologist","CAN",94
"Irving Kaplansky",1910,"2006",1,"Q3968"," university teacher","AUS",96
"Robert Recorde",1510,"1558",0,"physics"," physician","GBR",48
"Mauro Picone",1880,"1977",0,"mathematical analysis"," university teacher","ARG",97
"Israel Gohberg",1920,"2009",0,"functional analysis"," university teacher","UKR",89
"Harald Cramér",1890,"1985",1,"probability theory"," actuary","SWE",95
"Gaspard-Gustave Coriolis",1790,"1843",0,"mathematics"," physicist","CAN",53
"Harold Davenport",1900,"1969",1,"number theory"," university teacher","GBR",69
"Jean Leray",1900,"1998",1,"mathematical analysis"," topologist","BRA",98
"Stefan E. Warschawski",1900,"1989",0,"mathematical analysis"," university teacher","BLR",89
"Czeslaw Ryll-Nardzewski",1920,"2015",1,"model theory"," university teacher","LTU",95
"Norbert Wiener",1890,"1964",1,"mathematics"," probability theory","BOL",74
"Eduard Ritter von Weber",1870,"1934",0,"mathematical analysis"," university teacher","DEU",64
"Otto Stolz",1840,"1905",0,"mathematical analysis"," university teacher","AUT",65
"Rodion Kuzmin",1890,"1949",0,"mathematical analysis"," university teacher","BLR",59
"Jean Paul de Gua de Malves",1710,"1786",1,"geometry"," professor","FRA",76
"Oskar Perron",1880,"1975",1,"partial differential equation"," university teacher","DEU",95
"Seymour Papert",1920,"2016",1,"cognitive science"," computer scientist","ECU",96
"Pietro Cataldi",1550,"1626",0,"mathematics"," university teacher","ITA",76
"Zygmunt Janiszewski",1880,"1920",0,"topology"," topologist","JAM",40
"Leon Henkin",1920,"2006",1,"mathematics"," philosopher","AUS",86
"Sergey Yablonsky",1920,"1998",1,"mathematics"," computer scientist","RUS",78
"Heinrich August Rothe",1770,"1842",0,"combinatorics"," university teacher","CAN",72
"Louis-Benjamin Francœur",1770,"1849",1,"mathematics"," university teacher","CAN",79
"Henri Poincaré",1850,"1912",1,"algebraic geometry"," philosopher","BOL",62
"Daniel Bernoulli",1700,"1782",1,"mathematical analysis"," physicist","NLD",82
"Alonzo Church",1900,"1995",0,"mathematical logic"," philosopher","ARG",95
"Friedrich Engel (mathematician)",1860,"1941",0,"mathematics"," historian of mathematics","CZE",81
"Gustav Elfving",1900,"1984",0,"probability theory"," scientist","FIN",84
"Isabella Bashmakova",1920,"2005",0,"Q3968"," historian of mathematics","RUS",85
"John Wallis",1610,"1703",0,"mathematics"," historian of mathematics","AUS",93
"Émile Picard",1850,"1941",1,"mathematical analysis"," university teacher","CAN",91
"Béla Kerékjártó",1890,"1946",0,"topology"," topologist","HUN",56
"Oliver Heaviside",1850,"1925",1,"electromagnetism"," physicist","BLZ",75
"Albert W. Tucker",1900,"1995",1,"topology"," topologist","PER",95
"Louis Couturat",1860,"1914",0,"interlinguistics"," mathematician","FRA",54
"Joseph Fourier",1760,"1830",1,"mathematical analysis"," physicist","FRA",70
"Abram Ilyich Fet",1920,"2007",0,"differential geometry"," topologist","UKR",87
"Joseph Alfred Serret",1810,"1885",0,"geometry"," professor","CAN",75
"Naum Z. Shor",1930,"2006",1,"mathematical analysis"," computer scientist","RUS",76
"Bruno de Finetti",1900,"1985",0,"probability theory"," statistician","AUT",85
"Aryeh Dvoretzky",1910,"2008",1,"probability theory"," educator","RUS",98
"Leonida Tonelli",1880,"1946",0,"mathematical analysis"," non-fiction writer","ITA",66
"Giulio Ascoli",1840,"1896",0,"mathematical analysis"," university teacher","COL",56
"Bonaventura Cavalieri",1590,"1647",0,"mathematics"," astronomer","AFG",57
"Gheorghe Vrânceanu",1900,"1979",0,"differential geometry"," topologist","BIH",79
"Abraham Wald",1900,"1950",0,"functional analysis"," statistician","ROU",50
"William Rowan Hamilton",1800,"1865",1,"mathematics"," physicist","AUS",65
"Paul Halmos",1910,"2006",1,"Q3968"," philosopher","HUN",96
"Adolphe Quetelet",1790,"1874",0,"mathematics"," mathematician","BEL",84
"Richard Davis Anderson",1920,"2008",0,"topology"," topologist","USA",88
"Athanasios Papoulis",1920,"2002",1,"mathematics"," engineer","GRC",82
"H. J. Ryser",1920,"1985",0,"combinatorics"," university teacher","USA",65
"Lars Ahlfors",1900,"1996",1,"mathematical analysis"," university teacher","FIN",96
"Hermann Brunn",1860,"1939",0,"geometry"," librarian","BEL",79
"Heinrich Wilhelm Brandes",1770,"1834",0,"physics"," astronomer","DEU",64
"Solomon W. Golomb",1930,"2016",1,"combinatorics"," university teacher","COL",86
"Yehoshua Bar-Hillel",1910,"1975",0,"mathematical logic"," philosopher","AUT",65
"Claude Shannon",1910,"2001",1,"probability theory"," computer scientist","USA",91
"Étienne-Louis Malus",1770,"1812",1,"optics"," military personnel","CAN",42
"Erling Sverdrup",1910,"1994",0,"cryptography"," professor","AUT",84
"Isaac Barrow",1630,"1677",0,"physics"," historian of mathematics","BLZ",47
"Ludwig Boltzmann",1840,"1906",1,"theoretical physics"," university teacher","AUT",66
"Charles Dupin",1780,"1873",1,"differential geometry"," economist","FRA",93
"Henry P. H. Bromwell",1820,"1903",0,"geometry"," lawyer","COL",83
"Eric Temple Bell",1880,"1960",0,"combinatorics"," novelist","GBR",80
"Felix Berezin",1930,"1980",0,"algebra"," inventor","RUS",50
"Wilhelm Ackermann",1890,"1962",0,"mathematics"," university teacher","DEU",72
"Ernest Michael",1920,"2013",1,"mathematical analysis"," university teacher","CHE",93
"Marcel-Paul Schützenberger",1920,"1996",0,"combinatorics"," statistician","CAN",76
"Yuri Linnik",1910,"1972",1,"number theory"," university teacher","UKR",62
"Charles Sanders Peirce",1830,"1914",0,"lattice"," logician","AUS",84
"Moritz Cantor",1820,"1920",0,"history"," historian","DEU",100
"Gottfried Wilhelm Leibniz",1640,"1716",1,"mathematical analysis"," physicist","DEU",76
"Josiah Willard Gibbs",1830,"1903",1,"mathematical analysis"," chemist","BLZ",73
"Arthur Geoffrey Walker",1900,"2001",1,"differential geometry"," university teacher","CAN",101
"Eugene Wigner",1900,"1995",1,"physics"," university teacher","HUN",95
"Ernst Leonard Lindelöf",1870,"1946",0,"topology"," university teacher","FIN",76
"Alexis Clairaut",1710,"1765",1,"mathematics"," mechanic","CAN",55
"Edward Norton Lorenz",1910,"2008",1,"mathematics"," university teacher","USA",98
"Raymond Louis Wilder",1890,"1982",1,"topology"," topologist","AUS",92
"Friedrich Robert Helmert",1840,"1917",0,"geodesy"," statistician","AUT",77
"John L. Kelley",1910,"1999",0,"topology"," university teacher","USA",89
"Ruth Moufang",1900,"1977",0,"Q3968"," university teacher","DEU",77
"Marston Morse",1890,"1977",1,"topology"," university teacher","CAN",87
"William Stanley Jevons",1830,"1882",1,"economics"," statistician","AUS",52
"Thomas M. Cover",1930,"2012",1,"probability theory"," statistician","ARG",82
"José Celestino Mutis",1730,"1808",0,"botany"," physicist","COL",78
"Nathaniel Bowditch",1770,"1838",0,"mathematics"," actuary","DEU",68
"Frank Adams",1930,"1989",1,"topology"," topologist","AUS",59
"Jean-Victor Poncelet",1780,"1867",1,"mathematics"," physicist","AUS",87
"Paul Dirac",1900,"1984",1,"theoretical physics"," professor","CAN",84
"Marcel Brillouin",1850,"1948",1,"physicist"," professor","BEL",98
"Erasmus Reinhold",1510,"1553",0,"astronomy"," university teacher","DEU",43
"Klaus Wagner",1910,"2000",0,"graph theory"," university teacher","BRA",90
"Christopher Zeeman",1920,"2016",1,"topology"," university teacher","IDN",96
"Greg Hjorth",1960,"2011",1,"mathematical logic"," university teacher","AUS",51
"Nicolaas Govert de Bruijn",1910,"2012",0,"combinatorics"," computer scientist","NLD",102
"Andrey Markov, Jr.",1900,"1979",1,"mathematical logic"," university teacher","RUS",79
"Jon Barwise",1940,"2000",1,"mathematical logic"," university teacher","BLZ",60
"Horace Lamb",1840,"1934",1,"mathematics"," university teacher","AUS",94
"Evangelista Torricelli",1600,"1647",0,"physics"," inventor","ITA",47
"Hermann Grassmann",1800,"1877",0,"Q3968"," linguist","POL",77
"Ronald Ross",1850,"1932",1,"malaria"," epidemiologist","ESP",82
"Ralph Fox",1910,"1973",1,"topology"," university teacher","USA",63
"Giacinto Morera",1850,"1909",0,"mathematical analysis"," university teacher","ITA",59
"Élie Cartan",1860,"1951",1,"differential geometry"," physicist","FRA",91
"Alexander Kronrod",1920,"1986",1,"Function theory"," computer scientist","RUS",66
"Ludolph van Ceulen",1540,"1610",0,"mathematics"," university teacher","DEU",70
"Leonid Kantorovich",1910,"1986",1,"functional analysis"," university teacher","RUS",76
"Johannes Acronius Frisius",1520,"1564",0,"medicine"," university teacher","NLD",44
"Kurt Gödel",1900,"1978",1,"set theory"," poet","CZE",78
"Kazimierz Ajdukiewicz",1890,"1963",0,"logic"," translator","UKR",73
"Leonard Gillman",1910,"2009",1,"set theory"," pianist","AUS",99
"Mihailo Petrovic",1860,"1943",0,"mathematics"," inventor","BEL",83
"Ernst Kolman",1890,"1979",0,"mathematics"," university teacher","CZE",89
"Edward Nelson",1930,"2014",0,"set theory"," university teacher","USA",84
"Andreas Floer",1950,"1991",0,"topology"," university teacher","BEL",41
"Wilhelm Blaschke",1880,"1962",1,"differential geometry"," writer","AUT",82
"Ernst Zermelo",1870,"1953",1,"mathematical logic"," university teacher","COL",83
"Benjamin Peirce",1800,"1880",0,"Q3968"," statistician","DEU",80
"Francesco Maria Grimaldi",1610,"1663",0,"physicist"," astronomer","ITA",53
"Pierre-Simon Laplace",1740,"1827",1,"celestial mechanics"," physicist","FRA",87
"Joseph Diaz Gergonne",1770,"1859",0,"geometry"," university teacher","BOL",89
"John R. Stallings",1930,"2008",1,"group theory"," university teacher","USA",78
"Nikolai Smirnov (mathematician)",1900,"1966",1,"probability theory"," university teacher","RUS",66
"Oskar Anderson",1880,"1960",0,"mathematics"," statistician","BLR",80
"Émile Borel",1870,"1956",1,"probability theory"," university teacher","FRA",86
"Carl Friedrich Gauss",1770,"1855",1,"number theory"," astronomer","AUS",85
"Bertrand Russell",1870,"1970",1,"set theory"," essayist","GBR",100
"Clive Granger",1930,"2009",1,"economics"," university teacher","AUS",79
"René-Louis Baire",1870,"1932",0,"topology"," university teacher","CAN",62
"William Wallace (mathematician)",1760,"1843",0,"geometry"," engineer","AUS",83
"Jacob Wolfowitz",1910,"1981",1,"probability theory"," university teacher","USA",71
"Carl Adam Petri",1920,"2010",1,"mathematics"," engineer","DEU",90
"Herman Wold",1900,"1992",0,"probability theory"," statistician","NOR",92
"Jacques Philippe Marie Binet",1780,"1856",0,"astronomy"," professor","FRA",76
"René de Saussure",1860,"1943",0,"mathematics"," Esperantist","CHE",83
"László Kalmár",1900,"1976",1,"mathematical logic"," philosopher","HUN",76
"Eugene Lukacs",1900,"1987",0,"probability theory"," university teacher","HUN",87
"Edwin E. Moise",1910,"1998",1,"geometry"," university teacher","BRB",88
"Max Dehn",1870,"1952",0,"group theory"," topologist","DEU",82
"John Forbes Nash Jr.",1920,"2015",1,"partial differential equation"," university teacher","USA",95
"Klaus Matthes",1930,"1998",1,"probability theory"," university teacher","COL",68
"Waclaw Sierpinski",1880,"1969",1,"number theory"," university teacher","JAM",89
"Benoit Mandelbrot",1920,"2010",1,"fractal"," professor","JAM",90
"Gaspard Monge",1740,"1818",1,"differential geometry"," physicist","FRA",78
"Siméon Denis Poisson",1780,"1840",1,"mathematical analysis"," physicist","FRA",60
"Johann Jakob Balmer",1820,"1898",0,"mathematics"," university teacher","CHE",78
"Wu Wenjun",1910,"2017",1,"topology"," topologist","CHN",107
"Wilhelm Launhardt",1830,"1918",0,"mathematics"," university teacher","CAN",88
"Peter Hilton",1920,"2010",0,"topology"," university teacher","BLZ",90
"Farkas Bolyai",1770,"1856",0,"mathematics"," inventor","ERI",86
"Leonid Khachiyan",1950,"2005",1,"applied mathematics"," university teacher","RUS",55
"Adolph P. Yushkevich",1900,"1993",1,"history of mathematics"," historian","UKR",93
"Herbert A. Simon",1910,"2001",1,"economics"," politician","USA",91
"Giovanni Antonio Magini",1550,"1617",0,"cartography"," astrologer","BGD",67
"Henry Mann",1900,"2000",1,"group theory"," economist","AUT",100
"Duncan Sommerville",1870,"1934",1,"geometry"," painter","IND",64
"Armand Borel",1920,"2003",1,"topology"," university teacher","CHE",83
"Augustin-Louis Cauchy",1770,"1857",1,"mathematical analysis"," physicist","CAN",87
"Julius Weisbach",1800,"1871",0,"hydraulics"," university teacher","DEU",71
"Naum Meiman",1910,"2001",1,"physics"," human rights activist","BLR",91
"Paul Émile Appell",1850,"1930",1,"mathematical analysis"," scientist","BEL",80
"John William Theodore Youngs",1910,"1970",1,"graph theory"," university teacher","BGD",60
"Andrey Markov",1850,"1922",1,"probability theory"," university teacher","RUS",72
"Ronald Fisher",1890,"1962",1,"statistics"," statistician","BLZ",72
"Alfred Korzybski",1870,"1950",0,"engineering"," engineer","JAM",80
"Luigi Bodio",1840,"1920",0,"statistics"," university teacher","AFG",80
"George Pólya",1880,"1985",0,"mathematical analysis"," university teacher","HUN",105
"Enrico Betti",1820,"1892",0,"topology"," university teacher","ITA",72
"Richard Dedekind",1830,"1916",0,"Q3968"," university teacher","AUS",86
"Karl Menger",1900,"1985",1,"mathematics"," professor","AUT",85
"Leonard Jimmie Savage",1910,"1971",1,"mathematics"," university teacher","USA",61
"William Thurston",1940,"2012",1,"topology"," university teacher","ARG",72
"Vasili Yakovlevich Zinger",1830,"1907",0,"mathematics"," mathematician","RUS",77
"Mario Pieri",1860,"1913",0,"geometry"," university teacher","ITA",53
"Fokko du Cloux",1950,"2006",0,"computer science"," engineer","DEU",56
"John Hasbrouck Van Vleck",1890,"1980",1,"physics"," university teacher","AUS",90
"Samuel Karlin",1920,"2007",1,"functional analysis"," geneticist","USA",87
"Jean le Rond dAlembert",1710,"1783",1,"mathematics"," physicist","CAN",73
"Blaise Pascal",1620,"1662",0,"probability theory"," theologian","FRA",42
"Jurij Vega",1750,"1802",0,"computational mathematics"," astronomer","SVN",52
"Vladimir Arnold",1930,"2010",1,"mathematical analysis"," professor","UKR",80
"Galileo Galilei",1560,"1642",0,"astronomy"," mathematician","COL",82
"Thomas Fincke",1560,"1656",0,"trigonometry"," university teacher","DEU",96
"Hermann Minkowski",1860,"1909",1,"geometry"," university teacher","LTU",49
"Paul Lorenzen",1910,"1994",1,"proof theory"," university teacher","BEL",84
"Harry Bateman",1880,"1946",1,"mathematics"," non-fiction writer","BOL",66
"Charles Spearman",1860,"1945",1,"psychology"," university teacher","BLZ",85
"Martin Gardner",1910,"2010",0,"mathematics"," journalist","PAK",100
"Nikolay Mitrofanovich Krylov",1870,"1955",1,"mechanics"," university teacher","RUS",85
"Nikoloz Muskhelishvili",1890,"1976",1,"integral equation"," university teacher","GEO",86
"François Arago",1780,"1853",1,"physics"," physicist","FRA",73
"Jean-Christophe Yoccoz",1950,"2016",1,"mathematics"," chess player","CAN",66
"Louis Bachelier",1870,"1946",0,"probability theory"," non-fiction writer","CAN",76
"Theodor Vahlen",1860,"1945",0,"number theory"," university teacher","AUT",85
"Henry Thomas Colebrooke",1760,"1837",1,"Sanskrit"," Sanskrit scholar","BLZ",77
"James Hopwood Jeans",1870,"1946",1,"physics"," astronomer","GBR",76
"Satyendra Nath Bose",1890,"1974",1,"mathematical physics"," politician","IND",84
"Willem de Sitter",1870,"1934",1,"astronomy"," physicist","NLD",64
"Ismaël Bullialdus",1600,"1694",1,"astronomy"," librarian","CHN",94
"François Thureau-Dangin",1870,"1944",0,"Oriental studies"," mathematician","CAN",74
"Rajeev Motwani",1960,"2009",1,"informatics"," university teacher","IND",49
"Edwin Thompson Jaynes",1920,"1998",0,"statistical physics"," mathematician","AUS",78
"John Alan Robinson",1930,"2016",1,"mathematics"," engineer","BRB",86
"Gabriel Lamé",1790,"1870",1,"mathematics"," engineer","FRA",80
"Paul Gustav Heinrich Bachmann",1830,"1920",0,"group theory"," university teacher","COL",90
"Henri Brocard",1840,"1922",1,"geometry"," meteorologist","FRA",82
"Heiner Zieschang",1930,"2004",1,"topology"," university teacher","BEL",74
"Joseph Liouville",1800,"1882",1,"mathematical analysis"," engineer","FRA",82
"Johann Benedict Listing",1800,"1882",0,"topology"," physicist","DEU",82
"Nicolas Léonard Sadi Carnot",1790,"1832",0,"thermodynamics"," engineer","CAN",42
"Lorenzo Mascheroni",1750,"1800",0,"geometry"," poet","ITA",50
"Arnold S. Shapiro",1920,"1962",0,"topology"," university teacher","BOL",42
"Baha<U+02BE> al-din al-<U+02BF>Amili",1540,"1622",0,"mathematician"," astronomer","LBN",82
"Raphael M. Robinson",1910,"1995",0,"set theory"," university teacher","USA",85
"Stephen Cole Kleene",1900,"1994",1,"theoretical computer science"," philosopher","GBR",94
"Leonard Eugene Dickson",1870,"1954",1,"Q3968"," university teacher","PNG",84
"Hanna Neumann",1910,"1971",0,"group theory"," university teacher","COL",61
"Richard Lashof",1920,"2010",0,"topology"," university teacher","BRA",90
"James Clerk Maxwell",1830,"1879",1,"physics"," engineer","GBR",49
"Ruan Yuan",1760,"1849",0,"chinese philosophy"," philosopher","CHN",89
"Jerzy Neyman",1890,"1981",1,"mathematical analysis"," statistician","IDN",91
"Camille Jordan",1830,"1922",1,"group theory"," professor","ATG",92
"Józef Maria Hoene-Wronski",1770,"1853",0,"mathematics"," economist","POL",83
"Mary Ellen Rudin",1920,"2013",0,"topology"," university teacher","USA",93
"Kiiti Morita",1910,"1995",0,"Q3968"," university teacher","JPN",85
"Jagdish Chandra Bose",1850,"1937",1,"physics"," university teacher","IND",87
"Girard Desargues",1590,"1661",0,"geometry"," engineer","ATG",71
"Horst Schubert",1910,"2001",0,"topology"," university teacher","DEU",91
"Joseph Bertrand",1820,"1900",1,"probability theory"," professor","CAN",80
"Patrick Suppes",1920,"2014",1,"set theory"," university teacher","PAK",94
"Ernest Barnes",1870,"1953",1,"mathematics"," bishop","GBR",83
"Karl F. Sundman",1870,"1949",0,"mathematics"," university teacher","FIN",79
"André Weil",1900,"1998",1,"algebraic geometry"," university teacher","CAN",98
"Grigore Moisil",1900,"1973",1,"mathematical logic"," diplomat","ROU",73
"Vito Volterra",1860,"1940",1,"mathematical analysis"," university teacher","AUS",80
"Shimon Even",1930,"2004",0,"graph theory"," computer scientist","ISR",74
"Joseph Wedderburn",1880,"1948",1,"Q3968"," university teacher","GBR",68
"Johann Euler",1730,"1800",1,"mathematics"," physicist","RUS",70
"Ada Lovelace",1810,"1852",0,"computer science"," poet","BLZ",42
"Pierre Varignon",1650,"1722",1,"mathematical analysis"," physicist","ESP",72
"Jakow Trachtenberg",1880,"1953",0,"mathematics"," engineer","UKR",73
"Friedrich Bessel",1780,"1846",1,"mathematics"," university teacher","AUS",66
"Louis Poinsot",1770,"1859",1,"analytical mechanics"," politician","AUS",89
"Johannes Fallati",1800,"1855",0,"statistician"," university teacher","DEU",55
"Agner Krarup Erlang",1870,"1929",0,"queueing theory"," statistician","AUS",59
"Charles Babbage",1790,"1871",1,"mathematics"," engineer","BLZ",81
"Georges de Rham",1900,"1990",1,"topology"," university teacher","CHE",90
"Wilhelm Klingenberg",1920,"2010",0,"differential geometry"," writer","AUT",90
"Nicolas de Malézieu",1650,"1727",0,"Greek studies"," classical scholar","CAN",77
"Anatoli Georgievich Vitushkin",1930,"2004",1,"approximation theory"," university teacher","RUS",74
"H. F. Baker",1860,"1956",1,"partial differential equation"," university teacher","AUS",96
"James Waddell Alexander II",1880,"1971",1,"topology"," university teacher","USA",91
"Frank P. Ramsey",1900,"1930",0,"combinatorics"," economist","AUS",30
"Jakob Rosanes",1840,"1922",0,"algebraic geometry"," university teacher","BLR",82
"E. T. Whittaker",1870,"1956",1,"mathematics"," historian","AUS",86
"Emanuel Lasker",1860,"1941",1,"Q3968"," bridge player","POL",81
"Willebrord Snellius",1580,"1626",0,"mathematics"," physicist","NLD",46
"Gordon Thomas Whyburn",1900,"1969",1,"topology"," university teacher","USA",69
"Zoltán Tibor Balogh",1950,"2002",0,"topology"," university teacher","HUN",52
"Gerolamo Cardano",1500,"1576",0,"mathematics"," astronomer","COL",76
"William Kingdon Clifford",1840,"1879",1,"Q3968"," university teacher","AUS",39
"Paul Stäckel",1860,"1919",0,"differential geometry"," university teacher","COL",59
"Émile Lemoine",1840,"1912",1,"geometry"," engineer","FRA",72
"Mstislav Keldysh",1910,"1978",1,"mathematics"," university teacher","AFG",68
"Lazarus Fuchs",1830,"1902",1,"complex analysis"," university teacher","ITA",72
"Marian Rejewski",1900,"1980",1,"mathematics"," bodybuilding","POL",80
"Emmy Noether",1880,"1935",1,"Q3968"," university teacher","DEU",55
"Lucien Le Cam",1920,"2000",0,"probability theory"," university teacher","FRA",80
"George David Birkhoff",1880,"1944",0,"topology"," university teacher","USA",64
"Nicholas Metropolis",1910,"1999",1,"physics"," computer scientist","BLZ",89
"Raoul Bott",1920,"2005",1,"geometry"," topologist","HUN",85
"Eberhard Hopf",1900,"1983",1,"topology"," university teacher","AUT",83
"Hans Hahn (mathematician)",1870,"1934",1,"set theory"," topologist","AUT",64
"Raoul Bricard",1870,"1943",1,"geometry"," Esperantist","CAN",73
"Elwin Bruno Christoffel",1820,"1900",0,"differential geometry"," university teacher","DEU",80
"Grégoire de Saint-Vincent",1580,"1667",0,"geometry"," professor","BEL",87
"Michel Loève",1900,"1979",0,"probability theory"," university teacher","AUS",79
"Jean-Étienne Montucla",1720,"1799",0,"history of mathematics"," historian","ATG",79
"Carl Benjamin Boyer",1900,"1976",1,"history of mathematics"," historian","USA",76
"Pierre de Fermat",1600,"1665",0,"number theory"," lawyer","FRA",65
"John Maynard Smith",1920,"2004",1,"evolutionary biology"," geneticist","BLZ",84
"L. E. J. Brouwer",1880,"1966",1,"mathematical analysis"," topologist","NLD",86
"Kurt Reidemeister",1890,"1971",0,"topology"," university teacher","AUS",81
"Vojtech Jarník",1890,"1970",0,"mathematical physics"," university teacher","CZE",80
"Wassily Hoeffding",1910,"1991",0,"probability theory"," university teacher","CAN",81
"Giovanni Battista Amici",1780,"1863",1,"astronomy"," mathematician","ITA",83
"George Boole",1810,"1864",1,"mathematical logic"," logician","ARG",54
"Antoine Augustin Cournot",1800,"1877",0,"economics"," philosopher","AUT",77
"Richard von Mises",1880,"1953",0,"probability theory"," philosopher","UKR",73
"Max Mason",1870,"1961",0,"mathematical analysis"," university teacher","CAN",91
"Kazimierz Bartel",1880,"1941",1,"mathematics"," politician","UKR",61
"Alexander Esenin-Volpin",1920,"2016",0,"mathematical logic"," writer","RUS",96
"Leonhard Euler",1700,"1783",0,"mathematical analysis"," musicologist","BEL",83
"Abdus Salam",1920,"1996",1,"quantum field theory"," theoretical physicist","IND",76
"Corrado Gini",1880,"1965",0,"economics"," sociologist","ITA",85
"Johann Heinrich Lambert",1720,"1777",0,"physics"," physicist","FRA",57
"André-Marie Ampère",1770,"1836",1,"electromagnetism"," engineer","ATG",66
"Petr Vopenka",1930,"2015",1,"set theory"," educator","CZE",85
"Peter Gavin Hall",1950,"2016",1,"probability theory"," university teacher","AUS",66
"Sophie Germain",1770,"1831",1,"number theory"," philosopher","CAN",61
"Gilles de Roberval",1600,"1675",0,"mathematics"," professor","FRA",75
"Lorenz Leonard Lindelöf",1820,"1908",0,"analytic geometry"," university teacher","FIN",88
"Pasquale del Pezzo",1850,"1936",0,"algebraic geometry"," university teacher","COL",86
"Viggo Brun",1880,"1978",1,"number theory"," university teacher","ESP",98
"Carl Anton Bretschneider",1800,"1878",0,"geometry"," notary","AUT",78
"Georg Cantor",1840,"1918",1,"set theory"," university teacher","RUS",78
"Hermann Weyl",1880,"1955",1,"differential geometry"," philosopher","DEU",75
"Thomas L. Saaty",1920,"2017",0,"queueing theory"," journalist","AZE",97
"John Venn",1830,"1923",1,"mathematical logic"," university teacher","GBR",93
"Conrad Henfling",1640,"1716",0,"number theory"," music theorist","DEU",76
"Christiaan Huygens",1620,"1695",0,"mathematics"," physicist","NLD",75
"Aleksei Pogorelov",1910,"2002",1,"differential geometry"," university teacher","RUS",92
"Paul Tannery",1840,"1904",0,"history of mathematics"," translator","FRA",64
"Francis Galton",1820,"1911",1,"probability theory"," anthropologist","GBR",91
"Herbert Robbins",1910,"2001",1,"mathematics"," university teacher","CRI",91
"Vladimir Abramovich Rokhlin",1910,"1984",0,"algebraic geometry"," university teacher","AZE",74
"Andrey Kolmogorov",1900,"1987",1,"probability theory"," statistician","RUS",87
"James H. Wilkinson",1910,"1986",1,"numerical linear algebra"," scientist","GBR",76
"Paul Ehrenfest",1880,"1933",0,"theoretical physics"," university teacher","AUT",53
"Thomas Harriot",1560,"1621",0,"Q3968"," astronomer","BRB",61
"Karl Pearson",1850,"1936",1,"mathematical statistics"," statistician","BLZ",86
"Herbert Scarf",1930,"2015",1,"economics"," university teacher","BRA",85
"William S. Massey",1920,"2017",0,"topology"," university teacher","BLZ",97
"Christos Papakyriakopoulos",1910,"1976",1,"topology"," university teacher","GRC",66
"Oswald Veblen",1880,"1960",0,"geometry"," university teacher","PNG",80
"Sergey Chaplygin",1860,"1942",1,"mechanics"," engineer","RUS",82
"George Abram Miller",1860,"1951",0,"group theory"," university teacher","USA",91
"John Lennard-Jones",1890,"1954",1,"physics"," university teacher","GBR",64
"Thorvald N. Thiele",1830,"1910",0,"mathematics"," actuary","DNK",80
"Philippe Flajolet",1940,"2011",1,"computer science"," mathematician","ATG",71
"Giuseppe Peano",1850,"1932",0,"interlinguistics"," university teacher","ITA",82
"Nicholas Mercator",1620,"1687",0,"mathematics"," music theorist","DEU",67
"Andreas Cellarius",1590,"1665",0,"astronomy"," geographer","DEU",75
"John von Neumann",1900,"1957",1,"functional analysis"," chemist","HUN",57
"Theodor von Oppolzer",1840,"1886",0,"astronomy"," university teacher","CZE",46
"Philipp von Jolly",1800,"1884",0,"physics"," university teacher","DEU",84
"Johann Friedrich Pfaff",1760,"1825",0,"mathematical analysis"," university teacher","DEU",65
"Hans Freudenthal",1900,"1990",1,"topology"," topologist","DEU",90
"Ludvig Faddeev",1930,"2017",1,"mathematical physics"," inventor","RUS",87
"Émilie du Châtelet",1700,"1749",0,"mathematician"," linguist","CAN",49
"James Earl Baumgartner",1940,"2011",0,"mathematical logic"," university teacher","USA",71
"Valery Senderov",1940,"2014",0,"functional analysis"," dissident","RUS",74
"Danilo Blanuša",1900,"1987",0,"mathematics"," university teacher","BIH",87
"Øystein Ore",1890,"1968",1,"combinatorics"," university teacher","DNK",78
"Siegfried Gottwald",1940,"2015",1,"mathematical logic"," university teacher","AUT",75
"Irénée-Jules Bienaymé",1790,"1878",0,"statistics"," mathematician","CAN",88
"Oscar Zariski",1890,"1986",1,"algebraic geometry"," university teacher","BLR",96
"John Cocke",1920,"2002",1,"informatics"," engineer","HTI",82
"Abraham H. Taub",1910,"1999",1,"differential geometry"," university teacher","BLZ",89
"Bernhard Riemann",1820,"1866",0,"differential geometry"," university teacher","DEU",46
"Evert Willem Beth",1900,"1964",0,"mathematical logic"," engineer","NLD",64
"Laurent Schwartz",1910,"2002",1,"mathematics"," entomologist","CAN",92
"Alfred Russel Wallace",1820,"1913",1,"geometry"," explorer","CAN",93
"Alexander Alexandrovich Chuprov",1870,"1926",0,"statistics"," economist","RUS",56
"G. H. Hardy",1870,"1947",1,"mathematical analysis"," university teacher","GBR",77
"Paul Cohen",1930,"2007",1,"set theory"," university teacher","CAN",77
"Gian-Carlo Rota",1930,"1999",0,"combinatorics"," university teacher","ITA",69
"Edsger W. Dijkstra",1930,"2002",1,"informatics"," computer scientist","NLD",72
"Kazimierz Kuratowski",1890,"1980",0,"topology"," topologist","JAM",90
"Joseph-Louis Lagrange",1730,"1813",1,"mathematical analysis"," physicist","BLR",83
"François Viète",1540,"1603",0,"Q3968"," lawyer","FRA",63
"Samuel Eilenberg",1910,"1998",1,"topology"," university teacher","JAM",88
"Alan Turing",1910,"1954",1,"cryptanalysis"," university teacher","GBR",44
"Valentin Turchin",1930,"2010",0,"physics"," computer scientist","BLR",80
"George Gallup",1900,"1984",0,"political science"," mathematician","USA",84
"Carl Størmer",1870,"1957",1,"number theory"," astronomer","NOR",87
"Andreas von Ettingshausen",1790,"1878",0,"mathematics"," university teacher","AUS",88
"Jacques Charles François Sturm",1800,"1855",1,"mathematical physics"," university teacher","CHE",55
"Ulisse Dini",1840,"1918",0,"mathematics"," university teacher","COL",78
"Bartel Leendert van der Waerden",1900,"1996",1,"Q3968"," historian of mathematics","COL",96
"George W. Whitehead",1910,"2004",1,"topology"," university teacher","USA",94
"Patrick Billingsley",1920,"2011",0,"probability theory"," university teacher","USA",91
"James Joseph Sylvester",1810,"1897",1,"Q3968"," university teacher","BLZ",87
"Abraham Gotthelf Kästner",1710,"1800",1,"mathematics"," historian of mathematics","DEU",90
"Mikhail Lavrentyev",1900,"1980",1,"calculus of variations"," university teacher","AFG",80
"Bernard Bolzano",1780,"1848",0,"mathematical analysis"," philosopher of science","CZE",68
"Chung Kai-lai",1910,"2009",1,"probability theory"," university teacher","CHN",99
"Taqi ad-Din Muhammad ibn Maruf",1520,"1585",0,"astronomy"," engineer","SYR",65
"Jacob Bernoulli",1650,"1705",0,"probability theory"," physician","BEL",55
"Boris Berezovsky (businessman)",1940,"2013",1,"mathematics"," politician","RUS",73
"Nicolai A. Vasiliev",1880,"1940",0,"logic"," writer","AFG",60
"Marquis de Condorcet",1740,"1794",0,"mathematics"," economist","FRA",54
"Thomas Bayes",1700,"1761",1,"probability theory"," cleric","BLZ",61
"Florian Cajori",1850,"1930",0,"history of mathematics"," university teacher","CHE",80
"Giovanni Domenico Cassini",1620,"1712",1,"astronomy"," mathematician","ITA",92
"Israel Gelfand",1910,"2009",1,"mathematical analysis"," university teacher","UKR",99
"Samuel Earnshaw",1800,"1888",0,"physics"," university teacher","AUS",88
"Anders Johan Lexell",1740,"1784",0,"astronomy"," physicist","FIN",44
"Federigo Enriques",1870,"1946",0,"algebraic geometry"," philosopher","ITA",76
"George Kingsley Zipf",1900,"1950",1,"linguistics"," philologist","BHS",50
"Mary Somerville",1780,"1872",1,"popular science"," translator","GBR",92
"Maurice René Fréchet",1870,"1973",1,"mathematical analysis"," statistician","FRA",103
"Karol Borsuk",1900,"1982",0,"topology"," university teacher","JAM",82
"Norman Steenrod",1910,"1971",1,"topology"," university teacher","CAN",61
"Subrahmanyan Chandrasekhar",1910,"1995",1,"astrophysics"," astronomer","CMR",85
"Thomas Bartholin",1610,"1680",0,"medicine"," physician","DNK",70
"Robert Steinberg",1920,"2014",0,"group theory"," university teacher","MDA",94
"Hellmuth Kneser",1890,"1973",0,"group theory"," university teacher","EST",83
"Georges-Louis Leclerc, Comte de Buffon",1700,"1788",1,"biology"," ornithologist","FRA",88
"Meyer Bockstein",1910,"1990",0,"topology"," university teacher","RUS",80
"Arthur Cayley",1820,"1895",1,"graph theory"," university teacher","CAN",75
"Otto E. Neugebauer",1890,"1990",1,"mathematics"," historian of mathematics","AUT",100
"Georg Alexander Pick",1850,"1942",0,"mathematics"," university teacher","AUT",92
"William Oughtred",1570,"1660",0,"mathematics"," minister","AUS",90
"Karl Weierstrass",1810,"1897",1,"mathematical analysis"," 1841","DEU",87
"Johannes de Groot",1910,"1972",0,"topology"," university teacher","DEU",62
"Hugh Everett III",1930,"1982",0,"Q944"," theoretical physicist","ARG",52
"John Playfair",1740,"1819",1,"mathematics"," physicist","AUS",79
"Richard Crandall",1940,"2012",0,"number theory"," physicist","USA",72
"Johannes Kepler",1570,"1630",0,"optics"," theologian","DEU",60
"Douglas Hartree",1890,"1958",1,"theoretical physics"," professor","AUS",68
"Luis Santaló",1910,"2001",1,"differential geometry"," writer","ESP",91
"Rudolf E. Kálmán",1930,"2016",1,"control theory"," university teacher","HUN",86
"Mikhail Postnikov",1920,"2004",1,"topology"," university teacher","RUS",84
"Simion Stoilow",1880,"1961",0,"mathematical analysis"," university teacher","ROU",81
"Johann Friedrich Hennert",1730,"1813",0,"mathematical analysis"," university teacher","COL",83
"Igor Shafarevich",1920,"2017",1,"algebraic geometry"," university teacher","UKR",97
"Gaetano Fichera",1920,"1996",1,"mathematical analysis"," university teacher","ITA",76
"Willard Van Orman Quine",1900,"2000",1,"model theory"," philosopher of language","USA",100
"Étienne Laspeyres",1830,"1913",0,"statistics"," university teacher","BEL",83
"Adam Olearius",1600,"1671",0,"geography"," librarian","DEU",71
"Max Newman",1890,"1984",1,"mathematics"," computer scientist","BLZ",94
"Leopold Vietoris",1890,"2002",1,"topology"," university teacher","AUT",112
"Giambattista Benedetti",1530,"1590",0,"mechanics"," architect","CAN",60
"John Napier",1550,"1617",0,"mathematics"," astronomer","GBR",67
"George Dantzig",1910,"2005",1,"mathematics"," statistician","AUS",95
"Shimshon Amitsur",1920,"1994",1,"Q3968"," university teacher","BOL",74
"Nathaniel Bliss",1700,"1764",1,"astronomy"," university teacher","GBR",64
"Paul Sophus Epstein",1880,"1966",0,"theoretical physics"," university teacher","JAM",86
"Sofia Kovalevskaya",1850,"1891",1,"mathematics"," scientist","RUS",41
"Robert Lee Moore",1880,"1974",0,"topology"," university teacher","CAN",94
"Robert Recorde",1510,"1558",0,"physics"," physicist","GBR",48
"Harald Cramér",1890,"1985",1,"probability theory"," university teacher","SWE",95
"Gaspard-Gustave Coriolis",1790,"1843",0,"mathematics"," civil engineer","CAN",53
"Jean Leray",1900,"1998",1,"mathematical analysis"," professor","BRA",98
"Norbert Wiener",1890,"1964",1,"mathematics"," autobiographer","BOL",74
"Jean Paul de Gua de Malves",1710,"1786",1,"geometry"," economist","FRA",76
"Seymour Papert",1920,"2016",1,"cognitive science"," educator","ECU",96
"Leon Henkin",1920,"2006",1,"mathematics"," university teacher","AUS",86
"Louis-Benjamin Francœur",1770,"1849",1,"mathematics"," botanist","CAN",79
"Henri Poincaré",1850,"1912",1,"algebraic geometry"," astronomer","BOL",62
"Daniel Bernoulli",1700,"1782",1,"mathematical analysis"," university teacher","NLD",82
"Alonzo Church",1900,"1995",0,"mathematical logic"," university teacher","ARG",95
"Friedrich Engel (mathematician)",1860,"1941",0,"mathematics"," university teacher","CZE",81
"Gustav Elfving",1900,"1984",0,"probability theory"," statistician","FIN",84
"Isabella Bashmakova",1920,"2005",0,"Q3968"," university teacher","RUS",85
"John Wallis",1610,"1703",0,"mathematics"," philosopher","AUS",93
"Oliver Heaviside",1850,"1925",1,"electromagnetism"," engineer","BLZ",75
"Albert W. Tucker",1900,"1995",1,"topology"," university teacher","PER",95
"Louis Couturat",1860,"1914",0,"interlinguistics"," linguist","FRA",54
"Joseph Fourier",1760,"1830",1,"mathematical analysis"," historian","FRA",70
"Naum Z. Shor",1930,"2006",1,"mathematical analysis"," university teacher","RUS",76
"Bruno de Finetti",1900,"1985",0,"probability theory"," economist","AUT",85
"Aryeh Dvoretzky",1910,"2008",1,"probability theory"," university teacher","RUS",98
"Gheorghe Vrânceanu",1900,"1979",0,"differential geometry"," university teacher","BIH",79
"Abraham Wald",1900,"1950",0,"functional analysis"," scientist","ROU",50
"William Rowan Hamilton",1800,"1865",1,"mathematics"," astronomer","AUS",65
"Paul Halmos",1910,"2006",1,"Q3968"," statistician","HUN",96
"Adolphe Quetelet",1790,"1874",0,"mathematics"," scientist","BEL",84
"Heinrich Wilhelm Brandes",1770,"1834",0,"physics"," meteorologist","DEU",64
"Yehoshua Bar-Hillel",1910,"1975",0,"mathematical logic"," educator","AUT",65
"Claude Shannon",1910,"2001",1,"probability theory"," engineer","USA",91
"Étienne-Louis Malus",1770,"1812",1,"optics"," engineer","CAN",42
"Isaac Barrow",1630,"1677",0,"physics"," physicist","BLZ",47
"Ludwig Boltzmann",1840,"1906",1,"theoretical physics"," mathematician","AUT",66
"Charles Dupin",1780,"1873",1,"differential geometry"," engineer","FRA",93
"Henry P. H. Bromwell",1820,"1903",0,"geometry"," judge","COL",83
"Eric Temple Bell",1880,"1960",0,"combinatorics"," writer","GBR",80
"Marcel-Paul Schützenberger",1920,"1996",0,"combinatorics"," university teacher","CAN",76
"Charles Sanders Peirce",1830,"1914",0,"lattice"," pragmatist","AUS",84
"Gottfried Wilhelm Leibniz",1640,"1716",1,"mathematical analysis"," philosopher","DEU",76
"Josiah Willard Gibbs",1830,"1903",1,"mathematical analysis"," university teacher","BLZ",73
"Eugene Wigner",1900,"1995",1,"physics"," theoretical physicist","HUN",95
"Ernst Leonard Lindelöf",1870,"1946",0,"topology"," non-fiction writer","FIN",76
"Alexis Clairaut",1710,"1765",1,"mathematics"," physicist","CAN",55
"Raymond Louis Wilder",1890,"1982",1,"topology"," university teacher","AUS",92
"Friedrich Robert Helmert",1840,"1917",0,"geodesy"," university teacher","AUT",77
"José Celestino Mutis",1730,"1808",0,"botany"," botanist","COL",78
"Nathaniel Bowditch",1770,"1838",0,"mathematics"," physicist","DEU",68
"Jean-Victor Poncelet",1780,"1867",1,"mathematics"," university teacher","AUS",87
"Paul Dirac",1900,"1984",1,"theoretical physics"," physicist","CAN",84
"Hermann Grassmann",1800,"1877",0,"Q3968"," high school teacher","POL",77
"Ronald Ross",1850,"1932",1,"malaria"," poet","ESP",82
"Leonid Kantorovich",1910,"1986",1,"functional analysis"," scientist","RUS",76
"Johannes Acronius Frisius",1520,"1564",0,"medicine"," astronomer","NLD",44
"Kurt Gödel",1900,"1978",1,"set theory"," university teacher","CZE",78
"Kazimierz Ajdukiewicz",1890,"1963",0,"logic"," university teacher","UKR",73
"Mihailo Petrovic",1860,"1943",0,"mathematics"," university teacher","BEL",83
"Ernst Kolman",1890,"1979",0,"mathematics"," mathematician","CZE",89
"Pierre-Simon Laplace",1740,"1827",1,"celestial mechanics"," politician","FRA",87
"Carl Friedrich Gauss",1770,"1855",1,"number theory"," science writer","AUS",85
"Bertrand Russell",1870,"1970",1,"set theory"," logician","GBR",100
"William Wallace (mathematician)",1760,"1843",0,"geometry"," astronomer","AUS",83
"Carl Adam Petri",1920,"2010",1,"mathematics"," university teacher","DEU",90
"Herman Wold",1900,"1992",0,"probability theory"," university teacher","NOR",92
"Max Dehn",1870,"1952",0,"group theory"," university teacher","DEU",82
"Benoit Mandelbrot",1920,"2010",1,"fractal"," scientist","JAM",90
"Gaspard Monge",1740,"1818",1,"differential geometry"," university teacher","FRA",78
"Siméon Denis Poisson",1780,"1840",1,"mathematical analysis"," university teacher","FRA",60
"Adolph P. Yushkevich",1900,"1993",1,"history of mathematics"," university teacher","UKR",93
"Herbert A. Simon",1910,"2001",1,"economics"," sociologist","USA",91
"Duncan Sommerville",1870,"1934",1,"geometry"," historian","IND",64
"Augustin-Louis Cauchy",1770,"1857",1,"mathematical analysis"," university teacher","CAN",87
"Alfred Korzybski",1870,"1950",0,"engineering"," philosopher","JAM",80
"Leonard Jimmie Savage",1910,"1971",1,"mathematics"," economist","USA",61
"Vasili Yakovlevich Zinger",1830,"1907",0,"mathematics"," university teacher","RUS",77
"Samuel Karlin",1920,"2007",1,"functional analysis"," university teacher","USA",87
"Jean le Rond dAlembert",1710,"1783",1,"mathematics"," musicologist","CAN",73
"Blaise Pascal",1620,"1662",0,"probability theory"," physicist","FRA",42
"Jurij Vega",1750,"1802",0,"computational mathematics"," meteorologist","SVN",52
"Vladimir Arnold",1930,"2010",1,"mathematical analysis"," scientist","UKR",80
"Galileo Galilei",1560,"1642",0,"astronomy"," physicist","COL",82
"Martin Gardner",1910,"2010",0,"mathematics"," 1939","PAK",100
"François Arago",1780,"1853",1,"physics"," politician","FRA",73
"Henry Thomas Colebrooke",1760,"1837",1,"Sanskrit"," mathematician","BLZ",77
"James Hopwood Jeans",1870,"1946",1,"physics"," writer","GBR",76
"Satyendra Nath Bose",1890,"1974",1,"mathematical physics"," university teacher","IND",84
"Willem de Sitter",1870,"1934",1,"astronomy"," university teacher","NLD",64
"Ismaël Bullialdus",1600,"1694",1,"astronomy"," Catholic priest","CHN",94
"François Thureau-Dangin",1870,"1944",0,"Oriental studies"," historian of mathematics","CAN",74
"Gabriel Lamé",1790,"1870",1,"mathematics"," university teacher","FRA",80
"Joseph Liouville",1800,"1882",1,"mathematical analysis"," professor","FRA",82
"Johann Benedict Listing",1800,"1882",0,"topology"," university teacher","DEU",82
"Nicolas Léonard Sadi Carnot",1790,"1832",0,"thermodynamics"," scientist","CAN",42
"Baha<U+02BE> al-din al-<U+02BF>Amili",1540,"1622",0,"mathematician"," writer","LBN",82
"Stephen Cole Kleene",1900,"1994",1,"theoretical computer science"," university teacher","GBR",94
"James Clerk Maxwell",1830,"1879",1,"physics"," inventor","GBR",49
"Ruan Yuan",1760,"1849",0,"chinese philosophy"," politician","CHN",89
"Jagdish Chandra Bose",1850,"1937",1,"physics"," physicist","IND",87
"Patrick Suppes",1920,"2014",1,"set theory"," computer scientist","PAK",94
"Shimon Even",1930,"2004",0,"graph theory"," engineer","ISR",74
"Ada Lovelace",1810,"1852",0,"computer science"," computer scientist","BLZ",42
"Pierre Varignon",1650,"1722",1,"mathematical analysis"," professor","ESP",72
"Louis Poinsot",1770,"1859",1,"analytical mechanics"," university teacher","AUS",89
"Charles Babbage",1790,"1871",1,"mathematics"," economist","BLZ",81
"E. T. Whittaker",1870,"1956",1,"mathematics"," university teacher","AUS",86
"Willebrord Snellius",1580,"1626",0,"mathematics"," university teacher","NLD",46
"Gerolamo Cardano",1500,"1576",0,"mathematics"," inventor","COL",76
"Émile Lemoine",1840,"1912",1,"geometry"," university teacher","FRA",72
"Marian Rejewski",1900,"1980",1,"mathematics"," inventor","POL",80
"Raoul Bott",1920,"2005",1,"geometry"," university teacher","HUN",85
"Hans Hahn (mathematician)",1870,"1934",1,"set theory"," university teacher","AUT",64
"Raoul Bricard",1870,"1943",1,"geometry"," teacher","CAN",73
"Carl Benjamin Boyer",1900,"1976",1,"history of mathematics"," university teacher","USA",76
"John Maynard Smith",1920,"2004",1,"evolutionary biology"," zoologist","BLZ",84
"L. E. J. Brouwer",1880,"1966",1,"mathematical analysis"," university teacher","NLD",86
"Giovanni Battista Amici",1780,"1863",1,"astronomy"," physicist","ITA",83
"Antoine Augustin Cournot",1800,"1877",0,"economics"," university teacher","AUT",77
"Richard von Mises",1880,"1953",0,"probability theory"," engineer","UKR",73
"Kazimierz Bartel",1880,"1941",1,"mathematics"," university teacher","UKR",61
"Leonhard Euler",1700,"1783",0,"mathematical analysis"," music theorist","BEL",83
"Corrado Gini",1880,"1965",0,"economics"," demographer","ITA",85
"Johann Heinrich Lambert",1720,"1777",0,"physics"," philosopher","FRA",57
"André-Marie Ampère",1770,"1836",1,"electromagnetism"," professor","ATG",66
"Petr Vopenka",1930,"2015",1,"set theory"," university teacher","CZE",85
"Peter Gavin Hall",1950,"2016",1,"probability theory"," researcher","AUS",66
"Gilles de Roberval",1600,"1675",0,"mathematics"," physicist","FRA",75
"Hermann Weyl",1880,"1955",1,"differential geometry"," university teacher","DEU",75
"John Venn",1830,"1923",1,"mathematical logic"," computer scientist","GBR",93
"Christiaan Huygens",1620,"1695",0,"mathematics"," musicologist","NLD",75
"Aleksei Pogorelov",1910,"2002",1,"differential geometry"," politician","RUS",92
"Paul Tannery",1840,"1904",0,"history of mathematics"," historian","FRA",64
"Francis Galton",1820,"1911",1,"probability theory"," geneticist","GBR",91
"Andrey Kolmogorov",1900,"1987",1,"probability theory"," university teacher","RUS",87
"Paul Ehrenfest",1880,"1933",0,"theoretical physics"," mathematician","AUT",53
"Karl Pearson",1850,"1936",1,"mathematical statistics"," historian","BLZ",86
"John Lennard-Jones",1890,"1954",1,"physics"," chemist","GBR",64
"Thorvald N. Thiele",1830,"1910",0,"mathematics"," university teacher","DNK",80
"John von Neumann",1900,"1957",1,"functional analysis"," physicist","HUN",57
"Hans Freudenthal",1900,"1990",1,"topology"," university teacher","DEU",90
"Ludvig Faddeev",1930,"2017",1,"mathematical physics"," university teacher","RUS",87
"Émilie du Châtelet",1700,"1749",0,"mathematician"," writer","CAN",49
"John Cocke",1920,"2002",1,"informatics"," university teacher","HTI",82
"Evert Willem Beth",1900,"1964",0,"mathematical logic"," university teacher","NLD",64
"Alfred Russel Wallace",1820,"1913",1,"geometry"," anthropologist","CAN",93
"Edsger W. Dijkstra",1930,"2002",1,"informatics"," engineer","NLD",72
"Kazimierz Kuratowski",1890,"1980",0,"topology"," university teacher","JAM",90
"Joseph-Louis Lagrange",1730,"1813",1,"mathematical analysis"," politician","BLR",83
"Alan Turing",1910,"1954",1,"cryptanalysis"," cryptographer","GBR",44
"Valentin Turchin",1930,"2010",0,"physics"," mathematician","BLR",80
"George Gallup",1900,"1984",0,"political science"," journalist","USA",84
"Carl Størmer",1870,"1957",1,"number theory"," university teacher","NOR",87
"Patrick Billingsley",1920,"2011",0,"probability theory"," stage actor","USA",91
"Abraham Gotthelf Kästner",1710,"1800",1,"mathematics"," university teacher","DEU",90
"Bernard Bolzano",1780,"1848",0,"mathematical analysis"," theologian","CZE",68
"Taqi ad-Din Muhammad ibn Maruf",1520,"1585",0,"astronomy"," pharmacist","SYR",65
"Jacob Bernoulli",1650,"1705",0,"probability theory"," university teacher","BEL",55
"Boris Berezovsky (businessman)",1940,"2013",1,"mathematics"," economist","RUS",73
"Nicolai A. Vasiliev",1880,"1940",0,"logic"," psychologist","AFG",60
"Marquis de Condorcet",1740,"1794",0,"mathematics"," politician","FRA",54
"Giovanni Domenico Cassini",1620,"1712",1,"astronomy"," astronomer","ITA",92
"Anders Johan Lexell",1740,"1784",0,"astronomy"," university teacher","FIN",44
"Federigo Enriques",1870,"1946",0,"algebraic geometry"," university teacher","ITA",76
"Mary Somerville",1780,"1872",1,"popular science"," astronomer","GBR",92
"Maurice René Fréchet",1870,"1973",1,"mathematical analysis"," university teacher","FRA",103
"Thomas Bartholin",1610,"1680",0,"medicine"," anatomist","DNK",70
"Georges-Louis Leclerc, Comte de Buffon",1700,"1788",1,"biology"," scientist","FRA",88
"Otto E. Neugebauer",1890,"1990",1,"mathematics"," historian of science","AUT",100
"Karl Weierstrass",1810,"1897",1,"mathematical analysis"," university teacher","DEU",87
"Johannes Kepler",1570,"1630",0,"optics"," mathematician","DEU",60
"Douglas Hartree",1890,"1958",1,"theoretical physics"," computer scientist","AUS",68
"Willard Van Orman Quine",1900,"2000",1,"model theory"," epistemologist","USA",100
"Adam Olearius",1600,"1671",0,"geography"," diplomat","DEU",71
"Giambattista Benedetti",1530,"1590",0,"mechanics"," musicologist","CAN",60
"John Napier",1550,"1617",0,"mathematics"," physicist","GBR",67
"Sofia Kovalevskaya",1850,"1891",1,"mathematics"," novelist","RUS",41
"Robert Recorde",1510,"1558",0,"physics"," philosopher","GBR",48
"Gaspard-Gustave Coriolis",1790,"1843",0,"mathematics"," engineer","CAN",53
"Norbert Wiener",1890,"1964",1,"mathematics"," university teacher","BOL",74
"Jean Paul de Gua de Malves",1710,"1786",1,"geometry"," Encyclopédistes","FRA",76
"Seymour Papert",1920,"2016",1,"cognitive science"," university teacher","ECU",96
"Henri Poincaré",1850,"1912",1,"algebraic geometry"," physicist","BOL",62
"Daniel Bernoulli",1700,"1782",1,"mathematical analysis"," economist","NLD",82
"Alonzo Church",1900,"1995",0,"mathematical logic"," computer scientist","ARG",95
"John Wallis",1610,"1703",0,"mathematics"," musicologist","AUS",93
"Oliver Heaviside",1850,"1925",1,"electromagnetism"," telegraphy","BLZ",75
"Louis Couturat",1860,"1914",0,"interlinguistics"," historian of mathematics","FRA",54
"Joseph Fourier",1760,"1830",1,"mathematical analysis"," archaeologist","FRA",70
"Abraham Wald",1900,"1950",0,"functional analysis"," university teacher","ROU",50
"William Rowan Hamilton",1800,"1865",1,"mathematics"," scientist","AUS",65
"Adolphe Quetelet",1790,"1874",0,"mathematics"," criminologist","BEL",84
"Heinrich Wilhelm Brandes",1770,"1834",0,"physics"," university teacher","DEU",64
"Claude Shannon",1910,"2001",1,"probability theory"," sport cyclist","USA",91
"Isaac Barrow",1630,"1677",0,"physics"," university teacher","BLZ",47
"Ludwig Boltzmann",1840,"1906",1,"theoretical physics"," philosopher","AUT",66
"Eric Temple Bell",1880,"1960",0,"combinatorics"," science fiction writer","GBR",80
"Marcel-Paul Schützenberger",1920,"1996",0,"combinatorics"," physician","CAN",76
"Charles Sanders Peirce",1830,"1914",0,"lattice"," statistician","AUS",84
"Gottfried Wilhelm Leibniz",1640,"1716",1,"mathematical analysis"," diplomat","DEU",76
"Josiah Willard Gibbs",1830,"1903",1,"mathematical analysis"," theoretical physicist","BLZ",73
"José Celestino Mutis",1730,"1808",0,"botany"," university teacher","COL",78
"Nathaniel Bowditch",1770,"1838",0,"mathematics"," sailor","DEU",68
"Jean-Victor Poncelet",1780,"1867",1,"mathematics"," engineer","AUS",87
"Ronald Ross",1850,"1932",1,"malaria"," novelist","ESP",82
"Kurt Gödel",1900,"1978",1,"set theory"," computer scientist","CZE",78
"Kazimierz Ajdukiewicz",1890,"1963",0,"logic"," mathematician","UKR",73
"Pierre-Simon Laplace",1740,"1827",1,"celestial mechanics"," philosopher","FRA",87
"Carl Friedrich Gauss",1770,"1855",1,"number theory"," physicist","AUS",85
"Bertrand Russell",1870,"1970",1,"set theory"," epistemologist","GBR",100
"Benoit Mandelbrot",1920,"2010",1,"fractal"," writer","JAM",90
"Herbert A. Simon",1910,"2001",1,"economics"," university teacher","USA",91
"Jean le Rond dAlembert",1710,"1783",1,"mathematics"," translator","CAN",73
"Blaise Pascal",1620,"1662",0,"probability theory"," writer","FRA",42
"Jurij Vega",1750,"1802",0,"computational mathematics"," officer","SVN",52
"Galileo Galilei",1560,"1642",0,"astronomy"," inventor","COL",82
"Martin Gardner",1910,"2010",0,"mathematics"," literary critic","PAK",100
"François Arago",1780,"1853",1,"physics"," scientist","FRA",73
"Henry Thomas Colebrooke",1760,"1837",1,"Sanskrit"," historian of mathematics","BLZ",77
"James Hopwood Jeans",1870,"1946",1,"physics"," university teacher","GBR",76
"Baha<U+02BE> al-din al-<U+02BF>Amili",1540,"1622",0,"mathematician"," architect","LBN",82
"James Clerk Maxwell",1830,"1879",1,"physics"," photographer","GBR",49
"Ada Lovelace",1810,"1852",0,"computer science"," engineer","BLZ",42
"Charles Babbage",1790,"1871",1,"mathematics"," philosopher","BLZ",81
"Gerolamo Cardano",1500,"1576",0,"mathematics"," Médico de familia","COL",76
"John Maynard Smith",1920,"2004",1,"evolutionary biology"," writer","BLZ",84
"Giovanni Battista Amici",1780,"1863",1,"astronomy"," full professor","ITA",83
"Richard von Mises",1880,"1953",0,"probability theory"," university teacher","UKR",73
"Leonhard Euler",1700,"1783",0,"mathematical analysis"," university teacher","BEL",83
"André-Marie Ampère",1770,"1836",1,"electromagnetism"," philosopher","ATG",66
"Hermann Weyl",1880,"1955",1,"differential geometry"," psychologist","DEU",75
"Christiaan Huygens",1620,"1695",0,"mathematics"," inventor","NLD",75
"Paul Tannery",1840,"1904",0,"history of mathematics"," hellenist","FRA",64
"Francis Galton",1820,"1911",1,"probability theory"," psychologist","GBR",91
"Karl Pearson",1850,"1936",1,"mathematical statistics"," philosopher","BLZ",86
"John von Neumann",1900,"1957",1,"functional analysis"," engineer","HUN",57
"Émilie du Châtelet",1700,"1749",0,"mathematician"," salonnière","CAN",49
"Alfred Russel Wallace",1820,"1913",1,"geometry"," zoologist","CAN",93
"Edsger W. Dijkstra",1930,"2002",1,"informatics"," university teacher","NLD",72
"Joseph-Louis Lagrange",1730,"1813",1,"mathematical analysis"," university teacher","BLR",83
"Alan Turing",1910,"1954",1,"cryptanalysis"," logician","GBR",44
"Abraham Gotthelf Kästner",1710,"1800",1,"mathematics"," poet lawyer","DEU",90
"Bernard Bolzano",1780,"1848",0,"mathematical analysis"," Catholic priest","CZE",68
"Taqi ad-Din Muhammad ibn Maruf",1520,"1585",0,"astronomy"," astrologer","SYR",65
"Marquis de Condorcet",1740,"1794",0,"mathematics"," political scientist","FRA",54
"Giovanni Domenico Cassini",1620,"1712",1,"astronomy"," engineer","ITA",92
"Federigo Enriques",1870,"1946",0,"algebraic geometry"," non-fiction writer","ITA",76
"Mary Somerville",1780,"1872",1,"popular science"," scientist","GBR",92
"Georges-Louis Leclerc, Comte de Buffon",1700,"1788",1,"biology"," mathematician","FRA",88
"Otto E. Neugebauer",1890,"1990",1,"mathematics"," university teacher","AUT",100
"Johannes Kepler",1570,"1630",0,"optics"," astronomer","DEU",60
"Willard Van Orman Quine",1900,"2000",1,"model theory"," philosopher of science","USA",100
"Adam Olearius",1600,"1671",0,"geography"," translator","DEU",71
"Giambattista Benedetti",1530,"1590",0,"mechanics"," astronomer","CAN",60
"John Napier",1550,"1617",0,"mathematics"," inventor","GBR",67
"Sofia Kovalevskaya",1850,"1891",1,"mathematics"," university teacher","RUS",41
"Robert Recorde",1510,"1558",0,"physics"," scientist","GBR",48
"Norbert Wiener",1890,"1964",1,"mathematics"," psychologist","BOL",74
"Seymour Papert",1920,"2016",1,"cognitive science"," psychologist","ECU",96
"Henri Poincaré",1850,"1912",1,"algebraic geometry"," engineer","BOL",62
"John Wallis",1610,"1703",0,"mathematics"," music theorist","AUS",93
"Oliver Heaviside",1850,"1925",1,"electromagnetism"," 1868","BLZ",75
"Louis Couturat",1860,"1914",0,"interlinguistics"," university teacher","FRA",54
"Joseph Fourier",1760,"1830",1,"mathematical analysis"," university teacher","FRA",70
"Abraham Wald",1900,"1950",0,"functional analysis"," economist","ROU",50
"William Rowan Hamilton",1800,"1865",1,"mathematics"," university teacher","AUS",65
"Adolphe Quetelet",1790,"1874",0,"mathematics"," statistician","BEL",84
"Claude Shannon",1910,"2001",1,"probability theory"," university teacher","USA",91
"Ludwig Boltzmann",1840,"1906",1,"theoretical physics"," theoretical physicist","AUT",66
"Charles Sanders Peirce",1830,"1914",0,"lattice"," university teacher","AUS",84
"Gottfried Wilhelm Leibniz",1640,"1716",1,"mathematical analysis"," historian","DEU",76
"Ronald Ross",1850,"1932",1,"malaria"," malariologist","ESP",82
"Pierre-Simon Laplace",1740,"1827",1,"celestial mechanics"," university teacher","FRA",87
"Carl Friedrich Gauss",1770,"1855",1,"number theory"," geodesist","AUS",85
"Bertrand Russell",1870,"1970",1,"set theory"," philosopher of language","GBR",100
"Benoit Mandelbrot",1920,"2010",1,"fractal"," computer scientist","JAM",90
"Herbert A. Simon",1910,"2001",1,"economics"," computer scientist","USA",91
"Jean le Rond dAlembert",1710,"1783",1,"mathematics"," writer","CAN",73
"Blaise Pascal",1620,"1662",0,"probability theory"," French moralists","FRA",42
"Jurij Vega",1750,"1802",0,"computational mathematics"," geodesist","SVN",52
"Galileo Galilei",1560,"1642",0,"astronomy"," astrologer","COL",82
"Martin Gardner",1910,"2010",0,"mathematics"," science fiction writer","PAK",100
"François Arago",1780,"1853",1,"physics"," university teacher","FRA",73
"Henry Thomas Colebrooke",1760,"1837",1,"Sanskrit"," translator","BLZ",77
"Baha<U+02BE> al-din al-<U+02BF>Amili",1540,"1622",0,"mathematician"," astrologer","LBN",82
"James Clerk Maxwell",1830,"1879",1,"physics"," university teacher","GBR",49
"Charles Babbage",1790,"1871",1,"mathematics"," professor","BLZ",81
"Gerolamo Cardano",1500,"1576",0,"mathematics"," astrologer","COL",76
"John Maynard Smith",1920,"2004",1,"evolutionary biology"," economist","BLZ",84
"Leonhard Euler",1700,"1783",0,"mathematical analysis"," writer","BEL",83
"Christiaan Huygens",1620,"1695",0,"mathematics"," music theorist","NLD",75
"Paul Tannery",1840,"1904",0,"history of mathematics"," philosophy historian","FRA",64
"Francis Galton",1820,"1911",1,"probability theory"," scientist","GBR",91
"Karl Pearson",1850,"1936",1,"mathematical statistics"," biographer","BLZ",86
"John von Neumann",1900,"1957",1,"functional analysis"," inventor","HUN",57
"Émilie du Châtelet",1700,"1749",0,"mathematician"," translator","CAN",49
"Alfred Russel Wallace",1820,"1913",1,"geometry"," naturalist","CAN",93
"Alan Turing",1910,"1954",1,"cryptanalysis"," philosopher","GBR",44
"Bernard Bolzano",1780,"1848",0,"mathematical analysis"," 1804","CZE",68
"Marquis de Condorcet",1740,"1794",0,"mathematics"," sociologist","FRA",54
"Georges-Louis Leclerc, Comte de Buffon",1700,"1788",1,"biology"," writer","FRA",88
"Johannes Kepler",1570,"1630",0,"optics"," science writer","DEU",60
"Willard Van Orman Quine",1900,"2000",1,"model theory"," university teacher","USA",100
"Adam Olearius",1600,"1671",0,"geography"," writer","DEU",71
"Giambattista Benedetti",1530,"1590",0,"mechanics"," music theorist","CAN",60
"John Napier",1550,"1617",0,"mathematics"," astrologer","GBR",67
"Sofia Kovalevskaya",1850,"1891",1,"mathematics"," writer","RUS",41
"Norbert Wiener",1890,"1964",1,"mathematics"," computer scientist","BOL",74
"Seymour Papert",1920,"2016",1,"cognitive science"," artificial intelligence researcher","ECU",96
"Henri Poincaré",1850,"1912",1,"algebraic geometry"," philosopher of science","BOL",62
"John Wallis",1610,"1703",0,"mathematics"," cryptologist","AUS",93
"Oliver Heaviside",1850,"1925",1,"electromagnetism"," 1874","BLZ",75
"Louis Couturat",1860,"1914",0,"interlinguistics"," Idist","FRA",54
"William Rowan Hamilton",1800,"1865",1,"mathematics"," theoretical physicist","AUS",65
"Adolphe Quetelet",1790,"1874",0,"mathematics"," sociologist","BEL",84
"Gottfried Wilhelm Leibniz",1640,"1716",1,"mathematical analysis"," librarian","DEU",76
"Ronald Ross",1850,"1932",1,"malaria"," microbiologist","ESP",82
"Pierre-Simon Laplace",1740,"1827",1,"celestial mechanics"," theoretical physicist","FRA",87
"Carl Friedrich Gauss",1770,"1855",1,"number theory"," university teacher","AUS",85
"Bertrand Russell",1870,"1970",1,"set theory"," political activist","GBR",100
"Jean le Rond dAlembert",1710,"1783",1,"mathematics"," music theorist","CAN",73
"Jurij Vega",1750,"1802",0,"computational mathematics"," engineer","SVN",52
"Galileo Galilei",1560,"1642",0,"astronomy"," polymath","COL",82
"Martin Gardner",1910,"2010",0,"mathematics"," stage magician","PAK",100
"Henry Thomas Colebrooke",1760,"1837",1,"Sanskrit"," Bible translator","BLZ",77
"James Clerk Maxwell",1830,"1879",1,"physics"," theoretical physicist","GBR",49
"John Maynard Smith",1920,"2004",1,"evolutionary biology"," university teacher","BLZ",84
"Leonhard Euler",1700,"1783",0,"mathematical analysis"," teacher","BEL",83
"Christiaan Huygens",1620,"1695",0,"mathematics"," theoretical physicist","NLD",75
"Francis Galton",1820,"1911",1,"probability theory"," meteorologist","GBR",91
"John von Neumann",1900,"1957",1,"functional analysis"," economist","HUN",57
"Émilie du Châtelet",1700,"1749",0,"mathematician"," philosopher","CAN",49
"Alfred Russel Wallace",1820,"1913",1,"geometry"," writer","CAN",93
"Alan Turing",1910,"1954",1,"cryptanalysis"," artificial intelligence researcher","GBR",44
"Bernard Bolzano",1780,"1848",0,"mathematical analysis"," historian","CZE",68
"Marquis de Condorcet",1740,"1794",0,"mathematics"," writer","FRA",54
"Georges-Louis Leclerc, Comte de Buffon",1700,"1788",1,"biology"," naturalist","FRA",88
"Johannes Kepler",1570,"1630",0,"optics"," musicologist","DEU",60
"Willard Van Orman Quine",1900,"2000",1,"model theory"," professor","USA",100
"Adam Olearius",1600,"1671",0,"geography"," poet lawyer","DEU",71
"Henri Poincaré",1850,"1912",1,"algebraic geometry"," topologist","BOL",62
"John Wallis",1610,"1703",0,"mathematics"," university teacher","AUS",93
"Louis Couturat",1860,"1914",0,"interlinguistics"," Esperantist","FRA",54
"Gottfried Wilhelm Leibniz",1640,"1716",1,"mathematical analysis"," musicologist","DEU",76
"Ronald Ross",1850,"1932",1,"malaria"," zoologist","ESP",82
"Bertrand Russell",1870,"1970",1,"set theory"," metaphysician","GBR",100
"Jean le Rond dAlembert",1710,"1783",1,"mathematics"," Encyclopédistes","CAN",73
"Jurij Vega",1750,"1802",0,"computational mathematics"," noble","SVN",52
"Galileo Galilei",1560,"1642",0,"astronomy"," university teacher","COL",82
"Henry Thomas Colebrooke",1760,"1837",1,"Sanskrit"," magistrate","BLZ",77
"John Maynard Smith",1920,"2004",1,"evolutionary biology"," mathematician","BLZ",84
"Francis Galton",1820,"1911",1,"probability theory"," statistician","GBR",91
"John von Neumann",1900,"1957",1,"functional analysis"," nuclear scientist","HUN",57
"Alfred Russel Wallace",1820,"1913",1,"geometry"," anti-vaccine activist","CAN",93
"Bernard Bolzano",1780,"1848",0,"mathematical analysis"," epistemologist","CZE",68
"Marquis de Condorcet",1740,"1794",0,"mathematics"," biographer","FRA",54
"Georges-Louis Leclerc, Comte de Buffon",1700,"1788",1,"biology"," zoologist","FRA",88
"Johannes Kepler",1570,"1630",0,"optics"," physicist","DEU",60
"Willard Van Orman Quine",1900,"2000",1,"model theory"," philosopher","USA",100
"Adam Olearius",1600,"1671",0,"geography"," historian","DEU",71
"Henri Poincaré",1850,"1912",1,"algebraic geometry"," university teacher","BOL",62
"John Wallis",1610,"1703",0,"mathematics"," archivist","AUS",93
"Gottfried Wilhelm Leibniz",1640,"1716",1,"mathematical analysis"," scientist","DEU",76
"Bertrand Russell",1870,"1970",1,"set theory"," analytic philosopher","GBR",100
"Galileo Galilei",1560,"1642",0,"astronomy"," scientist","COL",82
"Francis Galton",1820,"1911",1,"probability theory"," philosopher","GBR",91
"John von Neumann",1900,"1957",1,"functional analysis"," university teacher","HUN",57
"Bernard Bolzano",1780,"1848",0,"mathematical analysis"," philosopher","CZE",68
"Georges-Louis Leclerc, Comte de Buffon",1700,"1788",1,"biology"," philosopher","FRA",88
"Johannes Kepler",1570,"1630",0,"optics"," cosmologist","DEU",60
"Gottfried Wilhelm Leibniz",1640,"1716",1,"mathematical analysis"," writer","DEU",76
"Bertrand Russell",1870,"1970",1,"set theory"," autobiographer","GBR",100
"Galileo Galilei",1560,"1642",0,"astronomy"," theoretical physicist","COL",82
"Francis Galton",1820,"1911",1,"probability theory"," sociologist","GBR",91
"Bernard Bolzano",1780,"1848",0,"mathematical analysis"," university teacher","CZE",68
"Johannes Kepler",1570,"1630",0,"optics"," music theorist","DEU",60
"Alexander Grothendieck",1920,"2014",1," functional analysis","mathematician","COL",94
"Carl Gustav Jacob Jacobi",1800,"1851",1," number theory","mathematician","DEU",51
"Nikolai Sergeevich Bakhvalov",1930,"2005",1," numerical analysis","mathematician","RUS",75
"Solomon W. Golomb",1930,"2016",1," number theory","mathematician","COL",86
"Yehoshua Bar-Hillel",1910,"1975",0," theoretical linguistics","mathematician","AUT",65
"Børge Jessen",1900,"1993",0," geometry","mathematician","DNK",93
"Nail Bakirov",1950,"2010",0," mathematical statistics","mathematician","KAZ",60
"Isaac Barrow",1630,"1677",0," mathematics","theologian","BLZ",47
"Jacob Tamarkin",1880,"1945",0," differential equation","mathematician","UKR",65
"D. D. Morduhai-Boltovskoi",1870,"1952",0," number theory","mathematician","KAZ",82
"Anatoly Karatsuba",1930,"2008",1," number theory","mathematician","RUS",78
"Lev Schnirelmann",1900,"1938",0," topology","mathematician","BLR",38
"Jarl Waldemar Lindeberg",1870,"1932",0," differential equation","mathematician","FIN",62
"Felix Berezin",1930,"1980",0," mathematical analysis","mathematician","RUS",50
"Leonty Magnitsky",1660,"1739",0," arithmetic","mathematician","RUS",79
"Ernest Michael",1920,"2013",1," topology","mathematician","CHE",93
"Sergey Nikolsky",1900,"2012",1," approximation theory","mathematician","RUS",112
"John Edensor Littlewood",1880,"1977",1," number theory","mathematician","AUS",97
"Yuri Linnik",1910,"1972",1," mathematical statistics","mathematician","UKR",62
"Moritz Cantor",1820,"1920",0," mathematics","mathematician","DEU",100
"Victor Lidskii",1920,"2008",1," mathematical physics","mathematician","UKR",88
"Viktor Bunyakovsky",1800,"1889",0," number theory","mathematician","AFG",89
"Vera Kublanovskaya",1920,"2012",0," numerical analysis","mathematician","RUS",92
"Yuri Petunin",1930,"2011",0," functional analysis","mathematician","RUS",81
"Heinrich Martin Weber",1840,"1913",0," number theory","mathematician","AUS",73
"Aleksey Letnikov",1830,"1888",0," differential equation","mathematician","RUS",58
"Andrei Bolibrukh",1950,"2003",0," differential equation","mathematician","RUS",53
"Arthur Milgram",1910,"1961",0," combinatorics","mathematician","BRA",51
"Mark Naimark",1900,"1978",0," Lie group","mathematician","UKR",78
"Charles B. Morrey Jr.",1900,"1984",0," partial differential equation","mathematician","USA",84
"Sergey Stechkin",1920,"1995",0," approximation theory","mathematician","RUS",75
"Arthur Geoffrey Walker",1900,"2001",1," general relativity","mathematician","CAN",101
"Alexis Clairaut",1710,"1765",1," mechanics","astronomer","CAN",55
"Edward Norton Lorenz",1910,"2008",1," meteorology","mathematician","USA",98
"Sofya Yanovskaya",1890,"1966",1," mathematical logic","mathematician","BLR",76
"George F C Griss",1890,"1953",0," mathematical logic","mathematician","COL",63
"Donald Dines Wall",1920,"2000",0," normal number","mathematician","NIC",80
"Aleksandr Gennadievich Kurosh",1900,"1971",1," Q3968","mathematician","RUS",71
"Jean-Victor Poncelet",1780,"1867",1," mechanics","mathematician","AUS",87
"Marcel Brillouin",1850,"1948",1," mathematics","mathematician","BEL",98
"Klaus Wagner",1910,"2000",0," topology","mathematician","BRA",90
"Julian Sochocki",1840,"1927",0," mathematical analysis","mathematician","JAM",87
"Greg Hjorth",1960,"2011",1," set theory","mathematician","AUS",51
"Nicolaas Govert de Bruijn",1910,"2012",0," graph theory","mathematician","NLD",102
"Andrey Markov, Jr.",1900,"1979",1," topology","mathematician","RUS",79
"Henri Lebesgue",1870,"1941",1," functional analysis","mathematician","FRA",71
"Antonio Maria Bordoni",1780,"1860",0," differential geometry","mathematician","ITA",80
"Hidehiko Yamabe",1920,"1960",0," group theory","mathematician","JPN",40
"Vyacheslav Stepanov",1880,"1950",1," mathematical physics","mathematician","RUS",70
"Werner Fenchel",1900,"1988",0," geometry","mathematician","COL",88
"J. V. Uspensky",1880,"1947",0," number theory","mathematician","MNG",67
"Nikolai Efimov",1910,"1982",1," applied mathematics","mathematician","RUS",72
"Francesco Severi",1870,"1961",0," mathematical analysis","mathematician","HRV",91
"Élie Cartan",1860,"1951",1," general relativity","mathematician","FRA",91
"Maryam Mirzakhani",1970,"2017",1," hyperbolic geometry","mathematician","IRN",47
"Raymond Paley",1900,"1933",0," graph theory","mathematician","GBR",33
"Tibor Gallai",1910,"1992",1," graph theory","mathematician","HUN",82
"Leonid Kantorovich",1910,"1986",1," linear programming","mathematician","RUS",76
"Nikolai Nikolaevich Yanenko",1920,"1984",1," differential equation","mathematician","ARM",64
"Kazimierz Ajdukiewicz",1890,"1963",0," ontology","philosopher","UKR",73
"Leonard Gillman",1910,"2009",1," topology","mathematician","AUS",99
"Nikolai Nikolayevich Vorobyov (mathematician)",1920,"1995",0," mathematical analysis","mathematician","RUS",75
"Konstantin Andreev",1840,"1921",0," mathematical analysis","mathematician","RUS",81
"Ernst Kolman",1890,"1979",0," physics","educator","CZE",89
"Sergei Fomin",1910,"1975",0," topology","mathematician","RUS",65
"Charles Hermite",1820,"1901",1," number theory","mathematician","FRA",81
"Ernst Zermelo",1870,"1953",1," set theory","mathematician","COL",83
"Benjamin Peirce",1800,"1880",0," number theory","mathematician","DEU",80
"Jakob Hermann",1670,"1733",0," mathematical analysis","mathematician","BEL",63
"György Elekes",1940,"2008",0," number theory","mathematician","HUN",68
"Francesco Maria Grimaldi",1610,"1663",0," astronomer","physicist","ITA",53
"Boris Moishezon",1930,"1993",1," Q3968","mathematician","UKR",63
"Pierre-Simon Laplace",1740,"1827",1," probability theory","mathematician","FRA",87
"Georgiy Shilov",1910,"1975",1," functional analysis","mathematician","BGR",65
"John R. Stallings",1930,"2008",1," topology","mathematician","USA",78
"Oleg Lupanov",1930,"2006",1," mathematical logic","mathematician","RUS",76
"Nikolai Smirnov (mathematician)",1900,"1966",1," mathematical statistics","mathematician","RUS",66
"Boris Delaunay",1890,"1980",1," computational geometry","mathematician","RUS",90
"Oskar Anderson",1880,"1960",0," mathematical statistics","mathematician","BLR",80
"Georgy Adelson-Velsky",1920,"2014",0," artificial intelligence","mathematician","ETH",94
"Carl Friedrich Gauss",1770,"1855",1," Q3968","mathematician","AUS",85
"Bertrand Russell",1870,"1970",1," history of philosophy","mathematician","GBR",100
"Nikolai Luzin",1880,"1950",1," set theory","mathematician","RUS",70
"Carl Adam Petri",1920,"2010",1," computer science","mathematician","DEU",90
"David George Kendall",1910,"2007",1," queueing theory","mathematician","CAN",97
"Richard Friederich Arens",1910,"2000",0," functional analysis","mathematician","DEU",90
"Edwin E. Moise",1910,"1998",1," topology","mathematician","BRB",88
"Max Dehn",1870,"1952",0," topology","mathematician","DEU",82
"John Forbes Nash Jr.",1920,"2015",1," game theory","mathematician","USA",95
"Renato Caccioppoli",1900,"1959",0," functional analysis","mathematician","ITA",59
"Waclaw Sierpinski",1880,"1969",1," topology","mathematician","JAM",89
"Vladimir Smirnov (mathematician)",1880,"1974",1," Function theory","mathematician","RUS",94
"Siméon Denis Poisson",1780,"1840",1," probability theory","mathematician","FRA",60
"Charles Jean de la Vallée-Poussin",1860,"1962",1," mathematical analysis","mathematician","BEL",102
"Giacomo F. Maraldi",1660,"1729",0," mathematics","astronomer","ITA",69
"Viacheslav Belavkin",1940,"2012",0," mathematical physics","mathematician","UKR",72
"Srinivasa Ramanujan",1880,"1920",1," number theory","mathematician","IND",40
"Aleksandr Nekrasov",1880,"1957",1," mechanics","mathematician","RUS",77
"Roland Dobrushin",1920,"1995",0," mathematical physics","mathematician","RUS",75
"Boris Yakovlevich Bukreev",1850,"1962",1," differential geometry","mathematician","RUS",112
"Leonid Khachiyan",1950,"2005",1," discrete mathematics","mathematician","RUS",55
"Herbert A. Simon",1910,"2001",1," cybernetics","economist","USA",91
"Alexander Abrosimov",1940,"2011",0," geometry","mathematician","ETH",71
"Garrett Birkhoff",1910,"1996",1," lattice","mathematician","CAN",86
"Henry Mann",1900,"2000",1," number theory","mathematician","AUT",100
"Augustin-Louis Cauchy",1770,"1857",1," geometry","mathematician","CAN",87
"Yasuaki Aida",1740,"1817",0," number theory","mathematician","JPN",77
"Paul Émile Appell",1850,"1930",1," geometry","mathematician","BEL",80
"Viktor Vladimirovich Nemytskii",1900,"1967",1," integral equation","mathematician","RUS",67
"John William Theodore Youngs",1910,"1970",1," topology","mathematician","BGD",60
"Andrey Markov",1850,"1922",1," mathematical analysis","mathematician","RUS",72
"Ronald Fisher",1890,"1962",1," genetics","mathematician","BLZ",72
"George Pólya",1880,"1985",0," combinatorics","mathematician","HUN",105
"Richard Dedekind",1830,"1916",0," number theory","mathematician","AUS",86
"Vyacheslav Vasilievich Sazonov",1930,"2002",1," measure theory","mathematician","RUS",72
"Vladimir Markovich Entov",1930,"2008",0," mechanics","mathematician","RUS",78
"Isidor Natanson",1900,"1964",0," Function theory","mathematician","CHE",64
"Vasili Yakovlevich Zinger",1830,"1907",0," botany","philosopher","RUS",77
"Samuel Karlin",1920,"2007",1," probability theory","mathematician","USA",87
"Alfréd Rényi",1920,"1970",1," combinatorics","mathematician","HUN",50
"Jean le Rond dAlembert",1710,"1783",1," mechanics","philosopher","CAN",73
"Ivan Petrovsky",1900,"1973",1," differential equation","mathematician","RUS",73
"Jacques Hadamard",1860,"1963",1," number theory","mathematician","ARG",103
"Vladimir Arnold",1930,"2010",1," topology","mathematician","UKR",80
"Felix Gantmacher",1900,"1964",1," mechanics","mathematician","UKR",64
"Galileo Galilei",1560,"1642",0," physics","astronomer","COL",82
"Pelageya Polubarinova-Kochina",1890,"1999",1," fluid mechanics","mathematician","KAZ",109
"Hermann Minkowski",1860,"1909",1," number theory","physicist","LTU",49
"Edwin Hewitt",1920,"1999",1," probability theory","mathematician","USA",79
"Fritz John",1910,"1994",1," partial differential equation","mathematician","COL",84
"Paul A. Catlin",1940,"1995",0," number theory","mathematician","CAN",55
"Nikolay Mitrofanovich Krylov",1870,"1955",1," theory of differential equations","mathematician","RUS",85
"Nikoloz Muskhelishvili",1890,"1976",1," Function theory","mathematician","GEO",86
"François Arago",1780,"1853",1," astronomy","astronomer","FRA",73
"Vyacheslav Ivanovich Lebedev",1930,"2010",1," mathematical physics","mathematician","RUS",80
"Mark Vishik",1920,"2012",0," functional analysis","mathematician","UKR",92
"James Hopwood Jeans",1870,"1946",1," astronomy","mathematician","GBR",76
"Dmitri Anosov",1930,"2014",1," differential geometry","mathematician","RUS",84
"Philip Hall",1900,"1982",1," group theory","mathematician","GBR",82
"Paul Gustav Heinrich Bachmann",1830,"1920",0," number theory","mathematician","COL",90
"Olga Ladyzhenskaya",1920,"2004",1," partial differential equation","mathematician","RUS",84
"Vitold Shmulyan",1910,"1944",0," topology","mathematician","KAZ",34
"Alexander Friedmann",1880,"1925",1," geophysics","mathematician","RUS",45
"Vitalii Ditkin",1910,"1987",1," functional analysis","mathematician","RUS",77
"Anatoly Maltsev",1900,"1967",1," Q3968","mathematician","RUS",67
"Alexander Ostrowski",1890,"1986",0," mathematical analysis","mathematician","RUS",96
"Michel Deza",1930,"2016",0," graph theory","mathematician","RUS",86
"Baha<U+02BE> al-din al-<U+02BF>Amili",1540,"1622",0," astronomer","mathematician","LBN",82
"Ennio de Giorgi",1920,"1996",0," partial differential equation","mathematician","ITA",76
"Leonard Eugene Dickson",1870,"1954",1," number theory","mathematician","PNG",84
"Andrei Petrovich Kiselyov",1850,"1940",1," Q3968","mathematician","RUS",90
"Hermann Hankel",1830,"1873",0," special function","mathematician","BEL",43
"Alexander Gelfond",1900,"1968",1," Function theory","mathematician","RUS",68
"James Clerk Maxwell",1830,"1879",1," mathematics","physicist","GBR",49
"Paul Finsler",1890,"1970",0," set theory","mathematician","DEU",80
"Niels Henrik Abel",1800,"1829",1," calculus","mathematician","NOR",29
"Kiiti Morita",1910,"1995",0," topology","mathematician","JPN",85
"András Hajnal",1930,"2016",0," graph theory","mathematician","HUN",86
"Antoni Zygmund",1900,"1992",1," functional analysis","mathematician","JAM",92
"Ferdinand Georg Frobenius",1840,"1917",0," group theory","mathematician","DEU",77
"Joseph Bertrand",1820,"1900",1," differential geometry","mathematician","CAN",80
"Ferdinand Minding",1800,"1885",1," differential calculus","mathematician","POL",85
"André Weil",1900,"1998",1," number theory","mathematician","CAN",98
"Paul Bernays",1880,"1977",0," set theory","mathematician","BLZ",97
"Vito Volterra",1860,"1940",1," functional analysis","mathematician","AUS",80
"Ilya Piatetski-Shapiro",1920,"2009",1," algebraic geometry","mathematician","RUS",89
"Nikita Moiseyev",1910,"2000",1," applied mathematics","mathematician","RUS",90
"Boris Koyalovich",1860,"1941",0," differential equation","mathematician","RUS",81
"Alexander Anderson (mathematician)",1580,"1620",0," geometry","mathematician","ATG",40
"Friedrich Bessel",1780,"1846",1," astronomy","astronomer","AUS",66
"Alfred Young",1870,"1940",1," group theory","mathematician","GBR",70
"Pavel Alexandrov",1890,"1982",1," set theory","mathematician","RUS",92
"Karl Weissenberg",1890,"1976",1," crystallography","mathematician","AUT",86
"Johannes Fallati",1800,"1855",0," historian","economist","DEU",55
"Robert Fricke",1860,"1930",0," group theory","mathematician","DEU",70
"Ervand Kogbetliantz",1880,"1974",0," geophysics","mathematician","RUS",94
"Kosaku Yosida",1900,"1990",1," functional analysis","mathematician","JPN",90
"Charles Babbage",1790,"1871",1," analytic philosophy","mathematician","BLZ",81
"Anatoli Georgievich Vitushkin",1930,"2004",1," complex analysis","mathematician","RUS",74
"Emil Grosswald",1910,"1989",0," number theory","mathematician","ROU",79
"E. H. Moore",1860,"1932",0," Q3968","mathematician","USA",72
"Dmitri Egorov",1860,"1931",1," integral equation","mathematician","RUS",71
"Paul Stäckel",1860,"1919",0," number theory","mathematician","COL",59
"Peter M. Gruber",1940,"2017",1," number theory","mathematician","AUT",77
"Aleksandr Lyapunov",1850,"1918",0," theory of differential equations","mathematician","RUS",68
"Mstislav Keldysh",1910,"1978",1," mechanics","mathematician","AFG",68
"Lazarus Fuchs",1830,"1902",1," differential geometry","mathematician","ITA",72
"Marian Rejewski",1900,"1980",1," cryptography","mathematician","POL",80
"Emmy Noether",1880,"1935",1," abstract algebra","mathematician","DEU",55
"Joseph Liberman",1910,"1941",0," geometry","mathematician","UKR",31
"Valentina Borok",1930,"2004",0," partial differential equation","mathematician","UKR",74
"Georges Henri Halphen",1840,"1889",1," differential geometry","mathematician","BRB",49
"Raoul Bott",1920,"2005",1," topology","mathematician","HUN",85
"Boris Vladimirovich Gnedenko",1910,"1995",1," mathematical statistics","mathematician","RUS",85
"Hans Hahn (mathematician)",1870,"1934",1," topology","mathematician","AUT",64
"Aleksandr Khinchin",1890,"1959",1," number theory","mathematician","RUS",69
"Sergei Sobolev",1900,"1989",1," functional analysis","mathematician","RUS",89
"Stefan Mazurkiewicz",1880,"1945",0," topology","mathematician","JAM",65
"Sergei Nikolaevich Chernikov",1910,"1987",1," Q3968","mathematician","RUS",77
"Sergey Mergelyan",1920,"2008",1," Function theory","mathematician","UKR",88
"László Rédei",1900,"1980",1," number theory","mathematician","HUN",80
"Boris Levin",1900,"1993",0," functional analysis","mathematician","UKR",93
"Margherita Piazzola Beloch",1870,"1976",0," algebraic topology","mathematician","ITA",106
"L. E. J. Brouwer",1880,"1966",1," mathematical logic","mathematician","NLD",86
"Paul Erdos",1910,"1996",1," combinatorics","mathematician","HUN",86
"Robert G. Bartle",1920,"2003",0," functional analysis","mathematician","NIC",83
"Samuel Dickstein (mathematician)",1850,"1939",0," number theory","mathematician","JAM",89
"Antoine Augustin Cournot",1800,"1877",0," mathematics","mathematician","AUT",77
"Ruslan Stratonovich",1930,"1997",1," theory of differential equations","mathematician","RUS",67
"Wladyslaw Orlicz",1900,"1990",0," topology","mathematician","POL",90
"Boleslav Mlodzeevskii",1850,"1923",0," algebraic geometry","mathematician","RUS",73
"Leonhard Euler",1700,"1783",0," number theory","mathematician","BEL",83
"Corrado Gini",1880,"1965",0," statistics","economist","ITA",85
"Walther von Dyck",1850,"1934",1," group theory","mathematician","DEU",84
"Eugène Charles Catalan",1810,"1894",0," number theory","mathematician","BEL",84
"Otto Blumenthal",1870,"1944",0," aerodynamics","mathematician","DEU",74
"Alexandre-Théophile Vandermonde",1730,"1796",0," combinatorics","mathematician","CAN",66
"Peter Gavin Hall",1950,"2016",1," mathematical statistics","mathematician","AUS",66
"Sophie Germain",1770,"1831",1," mechanics","mathematician","CAN",61
"Gilles de Roberval",1600,"1675",0," mechanics","philosopher","FRA",75
"Hermann Weyl",1880,"1955",1," number theory","mathematician","DEU",75
"Semyon Aranovich Gershgorin",1900,"1933",0," Function theory","mathematician","BLR",33
"Carl Hindenburg",1740,"1808",0," combinatorics","mathematician","CAN",68
"Christiaan Huygens",1620,"1695",0," mechanics","astronomer","NLD",75
"Roland Fraïssé",1920,"2008",0," model theory","mathematician","FRA",88
"Aleksei Pogorelov",1910,"2002",1," theory of differential equations","mathematician","RUS",92
"Lyudmila Keldysh",1900,"1976",1," geometry","mathematician","RUS",76
"Stanislaw Saks",1890,"1942",0," functional analysis","mathematician","POL",52
"Zahid Khalilov",1910,"1974",0," mechanics","mathematician","GEO",64
"Dénes Konig",1880,"1944",0," graph theory","mathematician","HUN",64
"Nikolai Günther",1870,"1941",1," mathematical physics","mathematician","RUS",71
"Viktor Wagner",1900,"1981",1," differential geometry","mathematician","RUS",81
"Alfred Tarski",1900,"1983",1," model theory","mathematician","JAM",83
"Vladimir Abramovich Rokhlin",1910,"1984",0," topology","mathematician","AZE",74
"Andrey Kolmogorov",1900,"1987",1," topology","mathematician","RUS",87
"Michael Lvovitch Tsetlin",1920,"1966",0," computer science","mathematician","RUS",46
"Eugene Dynkin",1920,"2014",1," probability theory","mathematician","RUS",94
"Victor Glushkov",1920,"1982",1," cybernetics","mathematician","RUS",62
"Gheorghe <U+021A>i<U+021B>eica",1870,"1939",0," geometry","mathematician","ROU",69
"Oswald Veblen",1880,"1960",0," topology","mathematician","PNG",80
"Sergey Chaplygin",1860,"1942",1," theory of differential equations","mathematician","RUS",82
"Mark Semenovich Pinsker",1920,"2003",1," information theory","mathematician","RUS",83
"Nicolaus II Bernoulli",1690,"1726",0," probability theory","mathematician","BEL",36
"Iosif Vorovich",1920,"2001",1," theory of elasticity","mathematician","RUS",81
"Lev Pontryagin",1900,"1988",1," Oscillation theory","mathematician","RUS",88
"Yaroslav Lopatinskii",1900,"1981",1," differential equation","mathematician","GEO",81
"John von Neumann",1900,"1957",1," operator theory","mathematician","HUN",57
"Philipp von Jolly",1800,"1884",0," mathematics","mathematician","DEU",84
"James Earl Baumgartner",1940,"2011",0," set theory","mathematician","USA",71
"Boris Trakhtenbrot",1920,"2016",1," cybernetics","mathematician","MDA",96
"Pyotr Novikov",1900,"1975",1," set theory","mathematician","RUS",75
"Pál Turán",1910,"1976",1," graph theory","mathematician","HUN",66
"Øystein Ore",1890,"1968",1," lattice","mathematician","DNK",78
"Alfred Russel Wallace",1820,"1913",1," naturalism","mathematician","CAN",93
"G. H. Hardy",1870,"1947",1," number theory","mathematician","GBR",77
"Joseph-Louis Lagrange",1730,"1813",1," number theory","mathematician","BLR",83
"François Viète",1540,"1603",0," cryptography","mathematician","FRA",63
"Johann Christian Martin Bartels",1760,"1836",0," mathematical analysis","mathematician","AUS",76
"Alan Turing",1910,"1954",1," computer science","computer scientist","GBR",44
"Mark Krein",1900,"1989",1," differential equation","mathematician","RUS",89
"Dmitry Grave",1860,"1939",1," analytic geometry","mathematician","RUS",79
"Valentin Turchin",1930,"2010",0," computer science","physicist","BLR",80
"Boris Demidovich",1900,"1977",1," mathematical analysis","mathematician","BLR",77
"Pierre Samuel",1920,"2009",0," Q3968","mathematician","CAN",89
"Josif Shtokalo",1890,"1987",1," history of mathematics","mathematician","UKR",97
"Boris Galerkin",1870,"1945",1," theory of elasticity","mathematician","BLR",75
"Bartel Leendert van der Waerden",1900,"1996",1," combinatorics","mathematician","COL",96
"Gilbert Hunt",1910,"2008",0," Markov process","tennis player","ARG",98
"James Joseph Sylvester",1810,"1897",1," combinatorics","mathematician","BLZ",87
"Lev Gutenmaher",1900,"1981",1," cybernetics","mathematician","UKR",81
"Mikhail Lavrentyev",1900,"1980",1," mechanics","mathematician","AFG",80
"Fridrikh Karpelevich",1920,"2000",0," probability theory","mathematician","RUS",80
"Jacob Bernoulli",1650,"1705",0," number theory","mathematician","BEL",55
"György Hajós",1910,"1972",1," geometry","mathematician","HUN",62
"Bernard Frénicle de Bessy",1600,"1675",0," number theory","mathematician","CAN",75
"Alexey Lyapunov",1910,"1973",1," set theory","mathematician","RUS",63
"Israel Gelfand",1910,"2009",1," functional analysis","mathematician","UKR",99
"Anders Johan Lexell",1740,"1784",0," trigonometry","astronomer","FIN",44
"Thomas Kirkman",1800,"1895",1," geometry","mathematician","AUS",95
"Anatoli Prudnikov",1920,"1999",0," numerical analysis","mathematician","RUS",79
"Cyparissos Stephanos",1850,"1917",0," geometry","mathematician","GBR",67
"Maurice René Fréchet",1870,"1973",1," functional analysis","mathematician","FRA",103
"W. T. Tutte",1910,"2002",1," graph theory","mathematician","AUS",92
"Andrey Nikolayevich Tikhonov",1900,"1993",1," functional analysis","mathematician","ARM",93
"Hellmuth Kneser",1890,"1973",0," topology","mathematician","EST",83
"Edward Charles Titchmarsh",1890,"1963",1," number theory","mathematician","AUS",73
"Georges-Louis Leclerc, Comte de Buffon",1700,"1788",1," geography","botanist","FRA",88
"Arthur Cayley",1820,"1895",1," group theory","mathematician","CAN",75
"Karl Weierstrass",1810,"1897",1," complex analysis","mathematician","DEU",87
"Marvin Knopp",1930,"2011",0," number theory","mathematician","BLZ",81
"Mkhitar Djrbashian",1910,"1994",1," mathematical analysis","mathematician","ARM",84
"Grigorii Fichtenholz",1880,"1959",1," Function theory","mathematician","UKR",79
"Douglas Hartree",1890,"1958",1," numerical analysis","mathematician","AUS",68
"Walter Rudin",1920,"2010",0," functional analysis","mathematician","AUT",90
"Luis Santaló",1910,"2001",1," integral geometry","mathematician","ESP",91
"Mikhail Postnikov",1920,"2004",1," mathematical analysis","mathematician","RUS",84
"Ralph Faudree",1930,"2015",1," graph theory","mathematician","BRB",85
"Johann Friedrich Hennert",1730,"1813",0," number theory","mathematician","COL",83
"Igor Shafarevich",1920,"2017",1," number theory","mathematician","UKR",97
"Gaetano Fichera",1920,"1996",1," partial differential equation","mathematician","ITA",76
"Willard Van Orman Quine",1900,"2000",1," set theory","mathematician","USA",100
"Pavel Urysohn",1890,"1924",0," differential equation","mathematician","UKR",34
"Isaak Yaglom",1920,"1988",0," history of mathematics","mathematician","UKR",68
"Nicolas Fuss",1750,"1826",0," mathematical analysis","mathematician","BEL",76
"Errett Bishop",1920,"1983",0," functional analysis","mathematician","ARG",63
"Max August Zorn",1900,"1993",0," set theory","mathematician","DEU",93
"Adam Olearius",1600,"1671",0," Oriental studies","mathematician","DEU",71
"Jacques-Louis Lions",1920,"2001",1," partial differential equation","mathematician","AUT",81
"Naum Akhiezer",1900,"1980",0," functional analysis","mathematician","BLR",80
"Karl Mikhailovich Peterson",1820,"1881",0," differential geometry","mathematician","AFG",61
"Sergei Natanovich Bernstein",1880,"1968",1," partial differential equation","mathematician","UKR",88
"Naum Ya. Vilenkin",1920,"1991",0," Q3968","mathematician","RUS",71
"Sofia Kovalevskaya",1850,"1891",1," mechanics","mathematician","RUS",41
"Irving Kaplansky",1910,"2006",1," group theory","mathematician","AUS",96
"Elisha Netanyahu",1910,"1986",0," mathematical analysis","mathematician","JAM",76
"Mauro Picone",1880,"1977",0," partial differential equation","mathematician","ARG",97
"Israel Gohberg",1920,"2009",0," integral equation","mathematician","UKR",89
"Valery Glivenko",1890,"1940",0," probability theory","mathematician","RUS",50
"Gaspard-Gustave Coriolis",1790,"1843",0," mechanics","mathematician","CAN",53
"Jean Leray",1900,"1998",1," partial differential equation","mathematician","BRA",98
"Norbert Wiener",1890,"1964",1," cybernetics","mathematician","BOL",74
"Rodion Kuzmin",1890,"1949",0," number theory","mathematician","BLR",59
"Nikolay Nekhoroshev",1940,"2008",0," Austronomia","mathematician","RUS",68
"Yurii Dmitrievich Sokolov",1890,"1971",1," integral equation","mathematician","RUS",81
"Georgii Evgenevich Shilov",1910,"1975",1," functional analysis","mathematician","BGR",65
"Sergey Yablonsky",1920,"1998",1," cybernetics","mathematician","RUS",78
"Henri Poincaré",1850,"1912",1," mathematical analysis","mathematician","BOL",62
"Daniel Bernoulli",1700,"1782",1," probability theory","mathematician","NLD",82
"Alonzo Church",1900,"1995",0," theoretical computer science","mathematician","ARG",95
"Isabella Bashmakova",1920,"2005",0," history of mathematics","mathematician","RUS",85
"Enzo Martinelli",1910,"1999",0," geometry","mathematician","ITA",89
"Oliver Heaviside",1850,"1925",1," vector algebra","mathematician","BLZ",75
"Abram Ilyich Fet",1920,"2007",0," topology","mathematician","UKR",87
"Mikhail Kadets",1920,"2011",0," functional analysis","mathematician","RUS",91
"Gheorghe Vrânceanu",1900,"1979",0," topology","mathematician","BIH",79
"Stephen Rallis",1940,"2012",0," representation theory","mathematician","GBR",72
"William Rowan Hamilton",1800,"1865",1," mechanics","mathematician","AUS",65
"Paul Halmos",1910,"2006",1," mathematical analysis","mathematician","HUN",96
"Alexander Grothendieck",1920,"2014",1," functional analysis"," university teacher","COL",94
"Carl Gustav Jacob Jacobi",1800,"1851",1," number theory"," university teacher","DEU",51
"Solomon W. Golomb",1930,"2016",1," number theory"," computer scientist","COL",86
"Yehoshua Bar-Hillel",1910,"1975",0," theoretical linguistics"," linguist","AUT",65
"Børge Jessen",1900,"1993",0," geometry"," university teacher","DNK",93
"Nail Bakirov",1950,"2010",0," mathematical statistics"," statistician","KAZ",60
"Isaac Barrow",1630,"1677",0," mathematics"," mathematician","BLZ",47
"Jacob Tamarkin",1880,"1945",0," differential equation"," university teacher","UKR",65
"Anatoly Karatsuba",1930,"2008",1," number theory"," university teacher","RUS",78
"Lev Schnirelmann",1900,"1938",0," topology"," topologist","BLR",38
"Jarl Waldemar Lindeberg",1870,"1932",0," differential equation"," statistician","FIN",62
"Felix Berezin",1930,"1980",0," mathematical analysis"," physicist","RUS",50
"Ernest Michael",1920,"2013",1," topology"," topologist","CHE",93
"Sergey Nikolsky",1900,"2012",1," approximation theory"," university teacher","RUS",112
"John Edensor Littlewood",1880,"1977",1," number theory"," university teacher","AUS",97
"Yuri Linnik",1910,"1972",1," mathematical statistics"," statistician","UKR",62
"Moritz Cantor",1820,"1920",0," mathematics"," historian of mathematics","DEU",100
"Viktor Bunyakovsky",1800,"1889",0," number theory"," teacher","AFG",89
"Heinrich Martin Weber",1840,"1913",0," number theory"," university teacher","AUS",73
"Andrei Bolibrukh",1950,"2003",0," differential equation"," university teacher","RUS",53
"Arthur Milgram",1910,"1961",0," combinatorics"," topologist","BRA",51
"Charles B. Morrey Jr.",1900,"1984",0," partial differential equation"," university teacher","USA",84
"Sergey Stechkin",1920,"1995",0," approximation theory"," university teacher","RUS",75
"Arthur Geoffrey Walker",1900,"2001",1," general relativity"," physicist","CAN",101
"Alexis Clairaut",1710,"1765",1," mechanics"," mathematician","CAN",55
"Edward Norton Lorenz",1910,"2008",1," meteorology"," meteorologist","USA",98
"Sofya Yanovskaya",1890,"1966",1," mathematical logic"," historian","BLR",76
"George F C Griss",1890,"1953",0," mathematical logic"," philosopher","COL",63
"Jean-Victor Poncelet",1780,"1867",1," mechanics"," politician","AUS",87
"Marcel Brillouin",1850,"1948",1," mathematics"," physicist","BEL",98
"Klaus Wagner",1910,"2000",0," topology"," topologist","BRA",90
"Greg Hjorth",1960,"2011",1," set theory"," chess player","AUS",51
"Nicolaas Govert de Bruijn",1910,"2012",0," graph theory"," university teacher","NLD",102
"Andrey Markov, Jr.",1900,"1979",1," topology"," topologist","RUS",79
"Henri Lebesgue",1870,"1941",1," functional analysis"," professor","FRA",71
"Vyacheslav Stepanov",1880,"1950",1," mathematical physics"," university teacher","RUS",70
"J. V. Uspensky",1880,"1947",0," number theory"," university teacher","MNG",67
"Nikolai Efimov",1910,"1982",1," applied mathematics"," university teacher","RUS",72
"Francesco Severi",1870,"1961",0," mathematical analysis"," university teacher","HRV",91
"Élie Cartan",1860,"1951",1," general relativity"," university teacher","FRA",91
"Maryam Mirzakhani",1970,"2017",1," hyperbolic geometry"," topologist","IRN",47
"Tibor Gallai",1910,"1992",1," graph theory"," university teacher","HUN",82
"Leonid Kantorovich",1910,"1986",1," linear programming"," economist","RUS",76
"Kazimierz Ajdukiewicz",1890,"1963",0," ontology"," educator","UKR",73
"Leonard Gillman",1910,"2009",1," topology"," topologist","AUS",99
"Ernst Kolman",1890,"1979",0," physics"," writer","CZE",89
"Sergei Fomin",1910,"1975",0," topology"," university teacher","RUS",65
"Charles Hermite",1820,"1901",1," number theory"," university teacher","FRA",81
"Ernst Zermelo",1870,"1953",1," set theory"," philosopher","COL",83
"Benjamin Peirce",1800,"1880",0," number theory"," astronomer","DEU",80
"Jakob Hermann",1670,"1733",0," mathematical analysis"," university teacher","BEL",63
"György Elekes",1940,"2008",0," number theory"," computer scientist","HUN",68
"Francesco Maria Grimaldi",1610,"1663",0," astronomer"," mathematician","ITA",53
"Pierre-Simon Laplace",1740,"1827",1," probability theory"," astronomer","FRA",87
"John R. Stallings",1930,"2008",1," topology"," topologist","USA",78
"Oleg Lupanov",1930,"2006",1," mathematical logic"," computer scientist","RUS",76
"Nikolai Smirnov (mathematician)",1900,"1966",1," mathematical statistics"," statistician","RUS",66
"Boris Delaunay",1890,"1980",1," computational geometry"," university teacher","RUS",90
"Oskar Anderson",1880,"1960",0," mathematical statistics"," economist","BLR",80
"Georgy Adelson-Velsky",1920,"2014",0," artificial intelligence"," computer scientist","ETH",94
"Carl Friedrich Gauss",1770,"1855",1," Q3968"," geophysicist","AUS",85
"Bertrand Russell",1870,"1970",1," history of philosophy"," social critic","GBR",100
"Nikolai Luzin",1880,"1950",1," set theory"," university teacher","RUS",70
"Carl Adam Petri",1920,"2010",1," computer science"," computer scientist","DEU",90
"David George Kendall",1910,"2007",1," queueing theory"," statistician","CAN",97
"Edwin E. Moise",1910,"1998",1," topology"," topologist","BRB",88
"Max Dehn",1870,"1952",0," topology"," historian of mathematics","DEU",82
"John Forbes Nash Jr.",1920,"2015",1," game theory"," economist","USA",95
"Renato Caccioppoli",1900,"1959",0," functional analysis"," university teacher","ITA",59
"Waclaw Sierpinski",1880,"1969",1," topology"," topologist","JAM",89
"Vladimir Smirnov (mathematician)",1880,"1974",1," Function theory"," university teacher","RUS",94
"Siméon Denis Poisson",1780,"1840",1," probability theory"," astronomer","FRA",60
"Charles Jean de la Vallée-Poussin",1860,"1962",1," mathematical analysis"," university teacher","BEL",102
"Giacomo F. Maraldi",1660,"1729",0," mathematics"," mathematician","ITA",69
"Roland Dobrushin",1920,"1995",0," mathematical physics"," physicist","RUS",75
"Leonid Khachiyan",1950,"2005",1," discrete mathematics"," computer scientist","RUS",55
"Herbert A. Simon",1910,"2001",1," cybernetics"," psychologist","USA",91
"Alexander Abrosimov",1940,"2011",0," geometry"," educator","ETH",71
"Garrett Birkhoff",1910,"1996",1," lattice"," university teacher","CAN",86
"Henry Mann",1900,"2000",1," number theory"," statistician","AUT",100
"Augustin-Louis Cauchy",1770,"1857",1," geometry"," engineer","CAN",87
"Paul Émile Appell",1850,"1930",1," geometry"," university teacher","BEL",80
"John William Theodore Youngs",1910,"1970",1," topology"," topologist","BGD",60
"Andrey Markov",1850,"1922",1," mathematical analysis"," statistician","RUS",72
"Ronald Fisher",1890,"1962",1," genetics"," geneticist","BLZ",72
"George Pólya",1880,"1985",0," combinatorics"," statistician","HUN",105
"Richard Dedekind",1830,"1916",0," number theory"," philosopher","AUS",86
"Vladimir Markovich Entov",1930,"2008",0," mechanics"," physicist","RUS",78
"Vasili Yakovlevich Zinger",1830,"1907",0," botany"," botanist","RUS",77
"Samuel Karlin",1920,"2007",1," probability theory"," statistician","USA",87
"Alfréd Rényi",1920,"1970",1," combinatorics"," university teacher","HUN",50
"Jean le Rond dAlembert",1710,"1783",1," mechanics"," mathematician","CAN",73
"Ivan Petrovsky",1900,"1973",1," differential equation"," university teacher","RUS",73
"Jacques Hadamard",1860,"1963",1," number theory"," professor","ARG",103
"Vladimir Arnold",1930,"2010",1," topology"," topologist","UKR",80
"Galileo Galilei",1560,"1642",0," physics"," philosopher","COL",82
"Pelageya Polubarinova-Kochina",1890,"1999",1," fluid mechanics"," historian of mathematics","KAZ",109
"Hermann Minkowski",1860,"1909",1," number theory"," mathematician","LTU",49
"Edwin Hewitt",1920,"1999",1," probability theory"," university teacher","USA",79
"Paul A. Catlin",1940,"1995",0," number theory"," university teacher","CAN",55
"Nikolay Mitrofanovich Krylov",1870,"1955",1," theory of differential equations"," physicist","RUS",85
"Nikoloz Muskhelishvili",1890,"1976",1," Function theory"," scientist","GEO",86
"François Arago",1780,"1853",1," astronomy"," mathematician","FRA",73
"Vyacheslav Ivanovich Lebedev",1930,"2010",1," mathematical physics"," university teacher","RUS",80
"James Hopwood Jeans",1870,"1946",1," astronomy"," physicist","GBR",76
"Paul Gustav Heinrich Bachmann",1830,"1920",0," number theory"," historian of mathematics","COL",90
"Olga Ladyzhenskaya",1920,"2004",1," partial differential equation"," university teacher","RUS",84
"Alexander Friedmann",1880,"1925",1," geophysics"," physicist","RUS",45
"Alexander Ostrowski",1890,"1986",0," mathematical analysis"," university teacher","RUS",96
"Baha<U+02BE> al-din al-<U+02BF>Amili",1540,"1622",0," astronomer"," scientist","LBN",82
"Leonard Eugene Dickson",1870,"1954",1," number theory"," historian of mathematics","PNG",84
"Hermann Hankel",1830,"1873",0," special function"," historian of mathematics","BEL",43
"Alexander Gelfond",1900,"1968",1," Function theory"," university teacher","RUS",68
"James Clerk Maxwell",1830,"1879",1," mathematics"," mathematician","GBR",49
"Paul Finsler",1890,"1970",0," set theory"," university teacher","DEU",80
"Niels Henrik Abel",1800,"1829",1," calculus"," university teacher","NOR",29
"Kiiti Morita",1910,"1995",0," topology"," topologist","JPN",85
"Antoni Zygmund",1900,"1992",1," functional analysis"," university teacher","JAM",92
"Ferdinand Georg Frobenius",1840,"1917",0," group theory"," university teacher","DEU",77
"Joseph Bertrand",1820,"1900",1," differential geometry"," economist","CAN",80
"Ferdinand Minding",1800,"1885",1," differential calculus"," university teacher","POL",85
"André Weil",1900,"1998",1," number theory"," historian of mathematics","CAN",98
"Paul Bernays",1880,"1977",0," set theory"," philosopher","BLZ",97
"Vito Volterra",1860,"1940",1," functional analysis"," physicist","AUS",80
"Ilya Piatetski-Shapiro",1920,"2009",1," algebraic geometry"," educator","RUS",89
"Boris Koyalovich",1860,"1941",0," differential equation"," chess player","RUS",81
"Friedrich Bessel",1780,"1846",1," astronomy"," mathematician","AUS",66
"Alfred Young",1870,"1940",1," group theory"," parson","GBR",70
"Pavel Alexandrov",1890,"1982",1," set theory"," university teacher","RUS",92
"Karl Weissenberg",1890,"1976",1," crystallography"," physicist","AUT",86
"Johannes Fallati",1800,"1855",0," historian"," statistician","DEU",55
"Robert Fricke",1860,"1930",0," group theory"," university teacher","DEU",70
"Kosaku Yosida",1900,"1990",1," functional analysis"," university teacher","JPN",90
"Charles Babbage",1790,"1871",1," analytic philosophy"," computer scientist","BLZ",81
"Anatoli Georgievich Vitushkin",1930,"2004",1," complex analysis"," computer scientist","RUS",74
"Emil Grosswald",1910,"1989",0," number theory"," university teacher","ROU",79
"Dmitri Egorov",1860,"1931",1," integral equation"," university teacher","RUS",71
"Paul Stäckel",1860,"1919",0," number theory"," historian of mathematics","COL",59
"Peter M. Gruber",1940,"2017",1," number theory"," university teacher","AUT",77
"Aleksandr Lyapunov",1850,"1918",0," theory of differential equations"," physicist","RUS",68
"Mstislav Keldysh",1910,"1978",1," mechanics"," engineer","AFG",68
"Lazarus Fuchs",1830,"1902",1," differential geometry"," teacher","ITA",72
"Marian Rejewski",1900,"1980",1," cryptography"," cryptologist","POL",80
"Emmy Noether",1880,"1935",1," abstract algebra"," physicist","DEU",55
"Raoul Bott",1920,"2005",1," topology"," physicist","HUN",85
"Boris Vladimirovich Gnedenko",1910,"1995",1," mathematical statistics"," historian of mathematics","RUS",85
"Hans Hahn (mathematician)",1870,"1934",1," topology"," philosopher","AUT",64
"Sergei Sobolev",1900,"1989",1," functional analysis"," university teacher","RUS",89
"Stefan Mazurkiewicz",1880,"1945",0," topology"," topologist","JAM",65
"Sergey Mergelyan",1920,"2008",1," Function theory"," scientist","UKR",88
"László Rédei",1900,"1980",1," number theory"," university teacher","HUN",80
"Boris Levin",1900,"1993",0," functional analysis"," university teacher","UKR",93
"Margherita Piazzola Beloch",1870,"1976",0," algebraic topology"," university teacher","ITA",106
"L. E. J. Brouwer",1880,"1966",1," mathematical logic"," philosopher","NLD",86
"Samuel Dickstein (mathematician)",1850,"1939",0," number theory"," educator","JAM",89
"Antoine Augustin Cournot",1800,"1877",0," mathematics"," economist","AUT",77
"Ruslan Stratonovich",1930,"1997",1," theory of differential equations"," physicist","RUS",67
"Wladyslaw Orlicz",1900,"1990",0," topology"," topologist","POL",90
"Boleslav Mlodzeevskii",1850,"1923",0," algebraic geometry"," university teacher","RUS",73
"Leonhard Euler",1700,"1783",0," number theory"," physicist","BEL",83
"Corrado Gini",1880,"1965",0," statistics"," statistician","ITA",85
"Walther von Dyck",1850,"1934",1," group theory"," university teacher","DEU",84
"Eugène Charles Catalan",1810,"1894",0," number theory"," university teacher","BEL",84
"Otto Blumenthal",1870,"1944",0," aerodynamics"," university teacher","DEU",74
"Alexandre-Théophile Vandermonde",1730,"1796",0," combinatorics"," chemist","CAN",66
"Peter Gavin Hall",1950,"2016",1," mathematical statistics"," statistician","AUS",66
"Sophie Germain",1770,"1831",1," mechanics"," physicist","CAN",61
"Gilles de Roberval",1600,"1675",0," mechanics"," mathematician","FRA",75
"Hermann Weyl",1880,"1955",1," number theory"," physicist","DEU",75
"Christiaan Huygens",1620,"1695",0," mechanics"," mathematician","NLD",75
"Roland Fraïssé",1920,"2008",0," model theory"," philosopher","FRA",88
"Aleksei Pogorelov",1910,"2002",1," theory of differential equations"," physicist","RUS",92
"Stanislaw Saks",1890,"1942",0," functional analysis"," university teacher","POL",52
"Dénes Konig",1880,"1944",0," graph theory"," university teacher","HUN",64
"Nikolai Günther",1870,"1941",1," mathematical physics"," university teacher","RUS",71
"Viktor Wagner",1900,"1981",1," differential geometry"," university teacher","RUS",81
"Alfred Tarski",1900,"1983",1," model theory"," philosopher","JAM",83
"Vladimir Abramovich Rokhlin",1910,"1984",0," topology"," topologist","AZE",74
"Andrey Kolmogorov",1900,"1987",1," topology"," computer scientist","RUS",87
"Eugene Dynkin",1920,"2014",1," probability theory"," university teacher","RUS",94
"Victor Glushkov",1920,"1982",1," cybernetics"," computer scientist","RUS",62
"Gheorghe <U+021A>i<U+021B>eica",1870,"1939",0," geometry"," university teacher","ROU",69
"Oswald Veblen",1880,"1960",0," topology"," topologist","PNG",80
"Sergey Chaplygin",1860,"1942",1," theory of differential equations"," physicist","RUS",82
"Mark Semenovich Pinsker",1920,"2003",1," information theory"," computer scientist","RUS",83
"Nicolaus II Bernoulli",1690,"1726",0," probability theory"," university teacher","BEL",36
"John von Neumann",1900,"1957",1," operator theory"," computer scientist","HUN",57
"Philipp von Jolly",1800,"1884",0," mathematics"," physicist","DEU",84
"James Earl Baumgartner",1940,"2011",0," set theory"," philosopher","USA",71
"Boris Trakhtenbrot",1920,"2016",1," cybernetics"," computer scientist","MDA",96
"Pál Turán",1910,"1976",1," graph theory"," university teacher","HUN",66
"Øystein Ore",1890,"1968",1," lattice"," historian of mathematics","DNK",78
"Alfred Russel Wallace",1820,"1913",1," naturalism"," biologist","CAN",93
"G. H. Hardy",1870,"1947",1," number theory"," scientist","GBR",77
"Joseph-Louis Lagrange",1730,"1813",1," number theory"," astronomer","BLR",83
"François Viète",1540,"1603",0," cryptography"," cryptographer","FRA",63
"Johann Christian Martin Bartels",1760,"1836",0," mathematical analysis"," educator","AUS",76
"Alan Turing",1910,"1954",1," computer science"," mathematician","GBR",44
"Mark Krein",1900,"1989",1," differential equation"," university teacher","RUS",89
"Valentin Turchin",1930,"2010",0," computer science"," human rights activist","BLR",80
"Pierre Samuel",1920,"2009",0," Q3968"," scientist","CAN",89
"Boris Galerkin",1870,"1945",1," theory of elasticity"," engineer","BLR",75
"Bartel Leendert van der Waerden",1900,"1996",1," combinatorics"," university teacher","COL",96
"Gilbert Hunt",1910,"2008",0," Markov process"," mathematician","ARG",98
"James Joseph Sylvester",1810,"1897",1," combinatorics"," actuary","BLZ",87
"Lev Gutenmaher",1900,"1981",1," cybernetics"," computer scientist","UKR",81
"Mikhail Lavrentyev",1900,"1980",1," mechanics"," physicist","AFG",80
"Jacob Bernoulli",1650,"1705",0," number theory"," physicist","BEL",55
"György Hajós",1910,"1972",1," geometry"," university teacher","HUN",62
"Alexey Lyapunov",1910,"1973",1," set theory"," computer scientist","RUS",63
"Israel Gelfand",1910,"2009",1," functional analysis"," biologist","UKR",99
"Anders Johan Lexell",1740,"1784",0," trigonometry"," mathematician","FIN",44
"Thomas Kirkman",1800,"1895",1," geometry"," topologist","AUS",95
"Cyparissos Stephanos",1850,"1917",0," geometry"," university teacher","GBR",67
"Maurice René Fréchet",1870,"1973",1," functional analysis"," Esperantist","FRA",103
"W. T. Tutte",1910,"2002",1," graph theory"," university teacher","AUS",92
"Andrey Nikolayevich Tikhonov",1900,"1993",1," functional analysis"," topologist","ARM",93
"Hellmuth Kneser",1890,"1973",0," topology"," topologist","EST",83
"Edward Charles Titchmarsh",1890,"1963",1," number theory"," university teacher","AUS",73
"Georges-Louis Leclerc, Comte de Buffon",1700,"1788",1," geography"," volcanologist","FRA",88
"Arthur Cayley",1820,"1895",1," group theory"," lawyer","CAN",75
"Karl Weierstrass",1810,"1897",1," complex analysis"," teacher","DEU",87
"Marvin Knopp",1930,"2011",0," number theory"," university teacher","BLZ",81
"Mkhitar Djrbashian",1910,"1994",1," mathematical analysis"," contributing editor","ARM",84
"Grigorii Fichtenholz",1880,"1959",1," Function theory"," university teacher","UKR",79
"Douglas Hartree",1890,"1958",1," numerical analysis"," physicist","AUS",68
"Walter Rudin",1920,"2010",0," functional analysis"," university teacher","AUT",90
"Luis Santaló",1910,"2001",1," integral geometry"," university teacher","ESP",91
"Mikhail Postnikov",1920,"2004",1," mathematical analysis"," topologist","RUS",84
"Ralph Faudree",1930,"2015",1," graph theory"," university teacher","BRB",85
"Johann Friedrich Hennert",1730,"1813",0," number theory"," astronomer","COL",83
"Igor Shafarevich",1920,"2017",1," number theory"," human rights activist","UKR",97
"Gaetano Fichera",1920,"1996",1," partial differential equation"," historian of mathematics","ITA",76
"Willard Van Orman Quine",1900,"2000",1," set theory"," analytic philosopher","USA",100
"Pavel Urysohn",1890,"1924",0," differential equation"," topologist","UKR",34
"Errett Bishop",1920,"1983",0," functional analysis"," university teacher","ARG",63
"Max August Zorn",1900,"1993",0," set theory"," university teacher","DEU",93
"Adam Olearius",1600,"1671",0," Oriental studies"," linguist","DEU",71
"Jacques-Louis Lions",1920,"2001",1," partial differential equation"," professor","AUT",81
"Sergei Natanovich Bernstein",1880,"1968",1," partial differential equation"," university teacher","UKR",88
"Sofia Kovalevskaya",1850,"1891",1," mechanics"," physicist","RUS",41
"Irving Kaplansky",1910,"2006",1," group theory"," university teacher","AUS",96
"Mauro Picone",1880,"1977",0," partial differential equation"," university teacher","ARG",97
"Israel Gohberg",1920,"2009",0," integral equation"," university teacher","UKR",89
"Gaspard-Gustave Coriolis",1790,"1843",0," mechanics"," physicist","CAN",53
"Jean Leray",1900,"1998",1," partial differential equation"," topologist","BRA",98
"Norbert Wiener",1890,"1964",1," cybernetics"," probability theory","BOL",74
"Rodion Kuzmin",1890,"1949",0," number theory"," university teacher","BLR",59
"Sergey Yablonsky",1920,"1998",1," cybernetics"," computer scientist","RUS",78
"Henri Poincaré",1850,"1912",1," mathematical analysis"," philosopher","BOL",62
"Daniel Bernoulli",1700,"1782",1," probability theory"," physicist","NLD",82
"Alonzo Church",1900,"1995",0," theoretical computer science"," philosopher","ARG",95
"Isabella Bashmakova",1920,"2005",0," history of mathematics"," historian of mathematics","RUS",85
"Oliver Heaviside",1850,"1925",1," vector algebra"," physicist","BLZ",75
"Abram Ilyich Fet",1920,"2007",0," topology"," topologist","UKR",87
"Gheorghe Vrânceanu",1900,"1979",0," topology"," topologist","BIH",79
"William Rowan Hamilton",1800,"1865",1," mechanics"," physicist","AUS",65
"Paul Halmos",1910,"2006",1," mathematical analysis"," philosopher","HUN",96
"Solomon W. Golomb",1930,"2016",1," number theory"," university teacher","COL",86
"Yehoshua Bar-Hillel",1910,"1975",0," theoretical linguistics"," philosopher","AUT",65
"Isaac Barrow",1630,"1677",0," mathematics"," historian of mathematics","BLZ",47
"Felix Berezin",1930,"1980",0," mathematical analysis"," inventor","RUS",50
"Ernest Michael",1920,"2013",1," topology"," university teacher","CHE",93
"Yuri Linnik",1910,"1972",1," mathematical statistics"," university teacher","UKR",62
"Moritz Cantor",1820,"1920",0," mathematics"," historian","DEU",100
"Arthur Geoffrey Walker",1900,"2001",1," general relativity"," university teacher","CAN",101
"Alexis Clairaut",1710,"1765",1," mechanics"," mechanic","CAN",55
"Edward Norton Lorenz",1910,"2008",1," meteorology"," university teacher","USA",98
"Jean-Victor Poncelet",1780,"1867",1," mechanics"," physicist","AUS",87
"Marcel Brillouin",1850,"1948",1," mathematics"," professor","BEL",98
"Klaus Wagner",1910,"2000",0," topology"," university teacher","BRA",90
"Greg Hjorth",1960,"2011",1," set theory"," university teacher","AUS",51
"Nicolaas Govert de Bruijn",1910,"2012",0," graph theory"," computer scientist","NLD",102
"Andrey Markov, Jr.",1900,"1979",1," topology"," university teacher","RUS",79
"Élie Cartan",1860,"1951",1," general relativity"," physicist","FRA",91
"Leonid Kantorovich",1910,"1986",1," linear programming"," university teacher","RUS",76
"Kazimierz Ajdukiewicz",1890,"1963",0," ontology"," translator","UKR",73
"Leonard Gillman",1910,"2009",1," topology"," pianist","AUS",99
"Ernst Kolman",1890,"1979",0," physics"," university teacher","CZE",89
"Ernst Zermelo",1870,"1953",1," set theory"," university teacher","COL",83
"Benjamin Peirce",1800,"1880",0," number theory"," statistician","DEU",80
"Francesco Maria Grimaldi",1610,"1663",0," astronomer"," astronomer","ITA",53
"Pierre-Simon Laplace",1740,"1827",1," probability theory"," physicist","FRA",87
"John R. Stallings",1930,"2008",1," topology"," university teacher","USA",78
"Nikolai Smirnov (mathematician)",1900,"1966",1," mathematical statistics"," university teacher","RUS",66
"Oskar Anderson",1880,"1960",0," mathematical statistics"," statistician","BLR",80
"Carl Friedrich Gauss",1770,"1855",1," Q3968"," astronomer","AUS",85
"Bertrand Russell",1870,"1970",1," history of philosophy"," essayist","GBR",100
"Carl Adam Petri",1920,"2010",1," computer science"," engineer","DEU",90
"Edwin E. Moise",1910,"1998",1," topology"," university teacher","BRB",88
"Max Dehn",1870,"1952",0," topology"," topologist","DEU",82
"John Forbes Nash Jr.",1920,"2015",1," game theory"," university teacher","USA",95
"Waclaw Sierpinski",1880,"1969",1," topology"," university teacher","JAM",89
"Siméon Denis Poisson",1780,"1840",1," probability theory"," physicist","FRA",60
"Leonid Khachiyan",1950,"2005",1," discrete mathematics"," university teacher","RUS",55
"Herbert A. Simon",1910,"2001",1," cybernetics"," politician","USA",91
"Henry Mann",1900,"2000",1," number theory"," economist","AUT",100
"Augustin-Louis Cauchy",1770,"1857",1," geometry"," physicist","CAN",87
"Paul Émile Appell",1850,"1930",1," geometry"," scientist","BEL",80
"John William Theodore Youngs",1910,"1970",1," topology"," university teacher","BGD",60
"Andrey Markov",1850,"1922",1," mathematical analysis"," university teacher","RUS",72
"Ronald Fisher",1890,"1962",1," genetics"," statistician","BLZ",72
"George Pólya",1880,"1985",0," combinatorics"," university teacher","HUN",105
"Richard Dedekind",1830,"1916",0," number theory"," university teacher","AUS",86
"Vasili Yakovlevich Zinger",1830,"1907",0," botany"," mathematician","RUS",77
"Samuel Karlin",1920,"2007",1," probability theory"," geneticist","USA",87
"Jean le Rond dAlembert",1710,"1783",1," mechanics"," physicist","CAN",73
"Vladimir Arnold",1930,"2010",1," topology"," professor","UKR",80
"Galileo Galilei",1560,"1642",0," physics"," mathematician","COL",82
"Hermann Minkowski",1860,"1909",1," number theory"," university teacher","LTU",49
"Nikolay Mitrofanovich Krylov",1870,"1955",1," theory of differential equations"," university teacher","RUS",85
"Nikoloz Muskhelishvili",1890,"1976",1," Function theory"," university teacher","GEO",86
"François Arago",1780,"1853",1," astronomy"," physicist","FRA",73
"James Hopwood Jeans",1870,"1946",1," astronomy"," astronomer","GBR",76
"Paul Gustav Heinrich Bachmann",1830,"1920",0," number theory"," university teacher","COL",90
"Baha<U+02BE> al-din al-<U+02BF>Amili",1540,"1622",0," astronomer"," astronomer","LBN",82
"Leonard Eugene Dickson",1870,"1954",1," number theory"," university teacher","PNG",84
"James Clerk Maxwell",1830,"1879",1," mathematics"," engineer","GBR",49
"Kiiti Morita",1910,"1995",0," topology"," university teacher","JPN",85
"Joseph Bertrand",1820,"1900",1," differential geometry"," professor","CAN",80
"André Weil",1900,"1998",1," number theory"," university teacher","CAN",98
"Vito Volterra",1860,"1940",1," functional analysis"," university teacher","AUS",80
"Friedrich Bessel",1780,"1846",1," astronomy"," university teacher","AUS",66
"Johannes Fallati",1800,"1855",0," historian"," university teacher","DEU",55
"Charles Babbage",1790,"1871",1," analytic philosophy"," engineer","BLZ",81
"Anatoli Georgievich Vitushkin",1930,"2004",1," complex analysis"," university teacher","RUS",74
"Paul Stäckel",1860,"1919",0," number theory"," university teacher","COL",59
"Mstislav Keldysh",1910,"1978",1," mechanics"," university teacher","AFG",68
"Lazarus Fuchs",1830,"1902",1," differential geometry"," university teacher","ITA",72
"Marian Rejewski",1900,"1980",1," cryptography"," bodybuilding","POL",80
"Emmy Noether",1880,"1935",1," abstract algebra"," university teacher","DEU",55
"Raoul Bott",1920,"2005",1," topology"," topologist","HUN",85
"Hans Hahn (mathematician)",1870,"1934",1," topology"," topologist","AUT",64
"L. E. J. Brouwer",1880,"1966",1," mathematical logic"," topologist","NLD",86
"Antoine Augustin Cournot",1800,"1877",0," mathematics"," philosopher","AUT",77
"Leonhard Euler",1700,"1783",0," number theory"," musicologist","BEL",83
"Corrado Gini",1880,"1965",0," statistics"," sociologist","ITA",85
"Peter Gavin Hall",1950,"2016",1," mathematical statistics"," university teacher","AUS",66
"Sophie Germain",1770,"1831",1," mechanics"," philosopher","CAN",61
"Gilles de Roberval",1600,"1675",0," mechanics"," professor","FRA",75
"Hermann Weyl",1880,"1955",1," number theory"," philosopher","DEU",75
"Christiaan Huygens",1620,"1695",0," mechanics"," physicist","NLD",75
"Aleksei Pogorelov",1910,"2002",1," theory of differential equations"," university teacher","RUS",92
"Vladimir Abramovich Rokhlin",1910,"1984",0," topology"," university teacher","AZE",74
"Andrey Kolmogorov",1900,"1987",1," topology"," statistician","RUS",87
"Oswald Veblen",1880,"1960",0," topology"," university teacher","PNG",80
"Sergey Chaplygin",1860,"1942",1," theory of differential equations"," engineer","RUS",82
"John von Neumann",1900,"1957",1," operator theory"," chemist","HUN",57
"Philipp von Jolly",1800,"1884",0," mathematics"," university teacher","DEU",84
"James Earl Baumgartner",1940,"2011",0," set theory"," university teacher","USA",71
"Øystein Ore",1890,"1968",1," lattice"," university teacher","DNK",78
"Alfred Russel Wallace",1820,"1913",1," naturalism"," explorer","CAN",93
"G. H. Hardy",1870,"1947",1," number theory"," university teacher","GBR",77
"Joseph-Louis Lagrange",1730,"1813",1," number theory"," physicist","BLR",83
"François Viète",1540,"1603",0," cryptography"," lawyer","FRA",63
"Alan Turing",1910,"1954",1," computer science"," university teacher","GBR",44
"Valentin Turchin",1930,"2010",0," computer science"," computer scientist","BLR",80
"Bartel Leendert van der Waerden",1900,"1996",1," combinatorics"," historian of mathematics","COL",96
"James Joseph Sylvester",1810,"1897",1," combinatorics"," university teacher","BLZ",87
"Mikhail Lavrentyev",1900,"1980",1," mechanics"," university teacher","AFG",80
"Jacob Bernoulli",1650,"1705",0," number theory"," physician","BEL",55
"Israel Gelfand",1910,"2009",1," functional analysis"," university teacher","UKR",99
"Anders Johan Lexell",1740,"1784",0," trigonometry"," physicist","FIN",44
"Maurice René Fréchet",1870,"1973",1," functional analysis"," statistician","FRA",103
"Hellmuth Kneser",1890,"1973",0," topology"," university teacher","EST",83
"Georges-Louis Leclerc, Comte de Buffon",1700,"1788",1," geography"," ornithologist","FRA",88
"Arthur Cayley",1820,"1895",1," group theory"," university teacher","CAN",75
"Karl Weierstrass",1810,"1897",1," complex analysis"," 1841","DEU",87
"Douglas Hartree",1890,"1958",1," numerical analysis"," professor","AUS",68
"Luis Santaló",1910,"2001",1," integral geometry"," writer","ESP",91
"Mikhail Postnikov",1920,"2004",1," mathematical analysis"," university teacher","RUS",84
"Johann Friedrich Hennert",1730,"1813",0," number theory"," university teacher","COL",83
"Igor Shafarevich",1920,"2017",1," number theory"," university teacher","UKR",97
"Gaetano Fichera",1920,"1996",1," partial differential equation"," university teacher","ITA",76
"Willard Van Orman Quine",1900,"2000",1," set theory"," philosopher of language","USA",100
"Adam Olearius",1600,"1671",0," Oriental studies"," librarian","DEU",71
"Sofia Kovalevskaya",1850,"1891",1," mechanics"," scientist","RUS",41
"Gaspard-Gustave Coriolis",1790,"1843",0," mechanics"," civil engineer","CAN",53
"Jean Leray",1900,"1998",1," partial differential equation"," professor","BRA",98
"Norbert Wiener",1890,"1964",1," cybernetics"," autobiographer","BOL",74
"Henri Poincaré",1850,"1912",1," mathematical analysis"," astronomer","BOL",62
"Daniel Bernoulli",1700,"1782",1," probability theory"," university teacher","NLD",82
"Alonzo Church",1900,"1995",0," theoretical computer science"," university teacher","ARG",95
"Isabella Bashmakova",1920,"2005",0," history of mathematics"," university teacher","RUS",85
"Oliver Heaviside",1850,"1925",1," vector algebra"," engineer","BLZ",75
"Gheorghe Vrânceanu",1900,"1979",0," topology"," university teacher","BIH",79
"William Rowan Hamilton",1800,"1865",1," mechanics"," astronomer","AUS",65
"Paul Halmos",1910,"2006",1," mathematical analysis"," statistician","HUN",96
"Yehoshua Bar-Hillel",1910,"1975",0," theoretical linguistics"," educator","AUT",65
"Isaac Barrow",1630,"1677",0," mathematics"," physicist","BLZ",47
"Alexis Clairaut",1710,"1765",1," mechanics"," physicist","CAN",55
"Jean-Victor Poncelet",1780,"1867",1," mechanics"," university teacher","AUS",87
"Leonid Kantorovich",1910,"1986",1," linear programming"," scientist","RUS",76
"Kazimierz Ajdukiewicz",1890,"1963",0," ontology"," university teacher","UKR",73
"Ernst Kolman",1890,"1979",0," physics"," mathematician","CZE",89
"Pierre-Simon Laplace",1740,"1827",1," probability theory"," politician","FRA",87
"Carl Friedrich Gauss",1770,"1855",1," Q3968"," science writer","AUS",85
"Bertrand Russell",1870,"1970",1," history of philosophy"," logician","GBR",100
"Carl Adam Petri",1920,"2010",1," computer science"," university teacher","DEU",90
"Max Dehn",1870,"1952",0," topology"," university teacher","DEU",82
"Siméon Denis Poisson",1780,"1840",1," probability theory"," university teacher","FRA",60
"Herbert A. Simon",1910,"2001",1," cybernetics"," sociologist","USA",91
"Augustin-Louis Cauchy",1770,"1857",1," geometry"," university teacher","CAN",87
"Vasili Yakovlevich Zinger",1830,"1907",0," botany"," university teacher","RUS",77
"Samuel Karlin",1920,"2007",1," probability theory"," university teacher","USA",87
"Jean le Rond dAlembert",1710,"1783",1," mechanics"," musicologist","CAN",73
"Vladimir Arnold",1930,"2010",1," topology"," scientist","UKR",80
"Galileo Galilei",1560,"1642",0," physics"," physicist","COL",82
"François Arago",1780,"1853",1," astronomy"," politician","FRA",73
"James Hopwood Jeans",1870,"1946",1," astronomy"," writer","GBR",76
"Baha<U+02BE> al-din al-<U+02BF>Amili",1540,"1622",0," astronomer"," writer","LBN",82
"James Clerk Maxwell",1830,"1879",1," mathematics"," inventor","GBR",49
"Charles Babbage",1790,"1871",1," analytic philosophy"," economist","BLZ",81
"Marian Rejewski",1900,"1980",1," cryptography"," inventor","POL",80
"Raoul Bott",1920,"2005",1," topology"," university teacher","HUN",85
"Hans Hahn (mathematician)",1870,"1934",1," topology"," university teacher","AUT",64
"L. E. J. Brouwer",1880,"1966",1," mathematical logic"," university teacher","NLD",86
"Antoine Augustin Cournot",1800,"1877",0," mathematics"," university teacher","AUT",77
"Leonhard Euler",1700,"1783",0," number theory"," music theorist","BEL",83
"Corrado Gini",1880,"1965",0," statistics"," demographer","ITA",85
"Peter Gavin Hall",1950,"2016",1," mathematical statistics"," researcher","AUS",66
"Gilles de Roberval",1600,"1675",0," mechanics"," physicist","FRA",75
"Hermann Weyl",1880,"1955",1," number theory"," university teacher","DEU",75
"Christiaan Huygens",1620,"1695",0," mechanics"," musicologist","NLD",75
"Aleksei Pogorelov",1910,"2002",1," theory of differential equations"," politician","RUS",92
"Andrey Kolmogorov",1900,"1987",1," topology"," university teacher","RUS",87
"John von Neumann",1900,"1957",1," operator theory"," physicist","HUN",57
"Alfred Russel Wallace",1820,"1913",1," naturalism"," anthropologist","CAN",93
"Joseph-Louis Lagrange",1730,"1813",1," number theory"," politician","BLR",83
"Alan Turing",1910,"1954",1," computer science"," cryptographer","GBR",44
"Valentin Turchin",1930,"2010",0," computer science"," mathematician","BLR",80
"Jacob Bernoulli",1650,"1705",0," number theory"," university teacher","BEL",55
"Anders Johan Lexell",1740,"1784",0," trigonometry"," university teacher","FIN",44
"Maurice René Fréchet",1870,"1973",1," functional analysis"," university teacher","FRA",103
"Georges-Louis Leclerc, Comte de Buffon",1700,"1788",1," geography"," scientist","FRA",88
"Karl Weierstrass",1810,"1897",1," complex analysis"," university teacher","DEU",87
"Douglas Hartree",1890,"1958",1," numerical analysis"," computer scientist","AUS",68
"Willard Van Orman Quine",1900,"2000",1," set theory"," epistemologist","USA",100
"Adam Olearius",1600,"1671",0," Oriental studies"," diplomat","DEU",71
"Sofia Kovalevskaya",1850,"1891",1," mechanics"," novelist","RUS",41
"Gaspard-Gustave Coriolis",1790,"1843",0," mechanics"," engineer","CAN",53
"Norbert Wiener",1890,"1964",1," cybernetics"," university teacher","BOL",74
"Henri Poincaré",1850,"1912",1," mathematical analysis"," physicist","BOL",62
"Daniel Bernoulli",1700,"1782",1," probability theory"," economist","NLD",82
"Alonzo Church",1900,"1995",0," theoretical computer science"," computer scientist","ARG",95
"Oliver Heaviside",1850,"1925",1," vector algebra"," telegraphy","BLZ",75
"William Rowan Hamilton",1800,"1865",1," mechanics"," scientist","AUS",65
"Isaac Barrow",1630,"1677",0," mathematics"," university teacher","BLZ",47
"Jean-Victor Poncelet",1780,"1867",1," mechanics"," engineer","AUS",87
"Kazimierz Ajdukiewicz",1890,"1963",0," ontology"," mathematician","UKR",73
"Pierre-Simon Laplace",1740,"1827",1," probability theory"," philosopher","FRA",87
"Carl Friedrich Gauss",1770,"1855",1," Q3968"," physicist","AUS",85
"Bertrand Russell",1870,"1970",1," history of philosophy"," epistemologist","GBR",100
"Herbert A. Simon",1910,"2001",1," cybernetics"," university teacher","USA",91
"Jean le Rond dAlembert",1710,"1783",1," mechanics"," translator","CAN",73
"Galileo Galilei",1560,"1642",0," physics"," inventor","COL",82
"François Arago",1780,"1853",1," astronomy"," scientist","FRA",73
"James Hopwood Jeans",1870,"1946",1," astronomy"," university teacher","GBR",76
"Baha<U+02BE> al-din al-<U+02BF>Amili",1540,"1622",0," astronomer"," architect","LBN",82
"James Clerk Maxwell",1830,"1879",1," mathematics"," photographer","GBR",49
"Charles Babbage",1790,"1871",1," analytic philosophy"," philosopher","BLZ",81
"Leonhard Euler",1700,"1783",0," number theory"," university teacher","BEL",83
"Hermann Weyl",1880,"1955",1," number theory"," psychologist","DEU",75
"Christiaan Huygens",1620,"1695",0," mechanics"," inventor","NLD",75
"John von Neumann",1900,"1957",1," operator theory"," engineer","HUN",57
"Alfred Russel Wallace",1820,"1913",1," naturalism"," zoologist","CAN",93
"Joseph-Louis Lagrange",1730,"1813",1," number theory"," university teacher","BLR",83
"Alan Turing",1910,"1954",1," computer science"," logician","GBR",44
"Georges-Louis Leclerc, Comte de Buffon",1700,"1788",1," geography"," mathematician","FRA",88
"Willard Van Orman Quine",1900,"2000",1," set theory"," philosopher of science","USA",100
"Adam Olearius",1600,"1671",0," Oriental studies"," translator","DEU",71
"Sofia Kovalevskaya",1850,"1891",1," mechanics"," university teacher","RUS",41
"Norbert Wiener",1890,"1964",1," cybernetics"," psychologist","BOL",74
"Henri Poincaré",1850,"1912",1," mathematical analysis"," engineer","BOL",62
"Oliver Heaviside",1850,"1925",1," vector algebra"," 1868","BLZ",75
"William Rowan Hamilton",1800,"1865",1," mechanics"," university teacher","AUS",65
"Pierre-Simon Laplace",1740,"1827",1," probability theory"," university teacher","FRA",87
"Carl Friedrich Gauss",1770,"1855",1," Q3968"," geodesist","AUS",85
"Bertrand Russell",1870,"1970",1," history of philosophy"," philosopher of language","GBR",100
"Herbert A. Simon",1910,"2001",1," cybernetics"," computer scientist","USA",91
"Jean le Rond dAlembert",1710,"1783",1," mechanics"," writer","CAN",73
"Galileo Galilei",1560,"1642",0," physics"," astrologer","COL",82
"François Arago",1780,"1853",1," astronomy"," university teacher","FRA",73
"Baha<U+02BE> al-din al-<U+02BF>Amili",1540,"1622",0," astronomer"," astrologer","LBN",82
"James Clerk Maxwell",1830,"1879",1," mathematics"," university teacher","GBR",49
"Charles Babbage",1790,"1871",1," analytic philosophy"," professor","BLZ",81
"Leonhard Euler",1700,"1783",0," number theory"," writer","BEL",83
"Christiaan Huygens",1620,"1695",0," mechanics"," music theorist","NLD",75
"John von Neumann",1900,"1957",1," operator theory"," inventor","HUN",57
"Alfred Russel Wallace",1820,"1913",1," naturalism"," naturalist","CAN",93
"Alan Turing",1910,"1954",1," computer science"," philosopher","GBR",44
"Georges-Louis Leclerc, Comte de Buffon",1700,"1788",1," geography"," writer","FRA",88
"Willard Van Orman Quine",1900,"2000",1," set theory"," university teacher","USA",100
"Adam Olearius",1600,"1671",0," Oriental studies"," writer","DEU",71
"Sofia Kovalevskaya",1850,"1891",1," mechanics"," writer","RUS",41
"Norbert Wiener",1890,"1964",1," cybernetics"," computer scientist","BOL",74
"Henri Poincaré",1850,"1912",1," mathematical analysis"," philosopher of science","BOL",62
"Oliver Heaviside",1850,"1925",1," vector algebra"," 1874","BLZ",75
"William Rowan Hamilton",1800,"1865",1," mechanics"," theoretical physicist","AUS",65
"Pierre-Simon Laplace",1740,"1827",1," probability theory"," theoretical physicist","FRA",87
"Carl Friedrich Gauss",1770,"1855",1," Q3968"," university teacher","AUS",85
"Bertrand Russell",1870,"1970",1," history of philosophy"," political activist","GBR",100
"Jean le Rond dAlembert",1710,"1783",1," mechanics"," music theorist","CAN",73
"Galileo Galilei",1560,"1642",0," physics"," polymath","COL",82
"James Clerk Maxwell",1830,"1879",1," mathematics"," theoretical physicist","GBR",49
"Leonhard Euler",1700,"1783",0," number theory"," teacher","BEL",83
"Christiaan Huygens",1620,"1695",0," mechanics"," theoretical physicist","NLD",75
"John von Neumann",1900,"1957",1," operator theory"," economist","HUN",57
"Alfred Russel Wallace",1820,"1913",1," naturalism"," writer","CAN",93
"Alan Turing",1910,"1954",1," computer science"," artificial intelligence researcher","GBR",44
"Georges-Louis Leclerc, Comte de Buffon",1700,"1788",1," geography"," naturalist","FRA",88
"Willard Van Orman Quine",1900,"2000",1," set theory"," professor","USA",100
"Adam Olearius",1600,"1671",0," Oriental studies"," poet lawyer","DEU",71
"Henri Poincaré",1850,"1912",1," mathematical analysis"," topologist","BOL",62
"Bertrand Russell",1870,"1970",1," history of philosophy"," metaphysician","GBR",100
"Jean le Rond dAlembert",1710,"1783",1," mechanics"," Encyclopédistes","CAN",73
"Galileo Galilei",1560,"1642",0," physics"," university teacher","COL",82
"John von Neumann",1900,"1957",1," operator theory"," nuclear scientist","HUN",57
"Alfred Russel Wallace",1820,"1913",1," naturalism"," anti-vaccine activist","CAN",93
"Georges-Louis Leclerc, Comte de Buffon",1700,"1788",1," geography"," zoologist","FRA",88
"Willard Van Orman Quine",1900,"2000",1," set theory"," philosopher","USA",100
"Adam Olearius",1600,"1671",0," Oriental studies"," historian","DEU",71
"Henri Poincaré",1850,"1912",1," mathematical analysis"," university teacher","BOL",62
"Bertrand Russell",1870,"1970",1," history of philosophy"," analytic philosopher","GBR",100
"Galileo Galilei",1560,"1642",0," physics"," scientist","COL",82
"John von Neumann",1900,"1957",1," operator theory"," university teacher","HUN",57
"Georges-Louis Leclerc, Comte de Buffon",1700,"1788",1," geography"," philosopher","FRA",88
"Bertrand Russell",1870,"1970",1," history of philosophy"," autobiographer","GBR",100
"Galileo Galilei",1560,"1642",0," physics"," theoretical physicist","COL",82
"Nikolai Sergeevich Bakhvalov",1930,"2005",1," Function theory","mathematician","RUS",75
"Isaac Barrow",1630,"1677",0," theology","theologian","BLZ",47
"D. D. Morduhai-Boltovskoi",1870,"1952",0," projective geometry","mathematician","KAZ",82
"Anatoly Karatsuba",1930,"2008",1," physics","mathematician","RUS",78
"Jarl Waldemar Lindeberg",1870,"1932",0," mathematical statistics","mathematician","FIN",62
"Felix Berezin",1930,"1980",0," geometry","mathematician","RUS",50
"Sergey Nikolsky",1900,"2012",1," differential equation","mathematician","RUS",112
"Yuri Linnik",1910,"1972",1," probability theory","mathematician","UKR",62
"Victor Lidskii",1920,"2008",1," differential equation","mathematician","UKR",88
"Viktor Bunyakovsky",1800,"1889",0," probability theory","mathematician","AFG",89
"Andrei Bolibrukh",1950,"2003",0," topology","mathematician","RUS",53
"Arthur Milgram",1910,"1961",0," differential geometry","mathematician","BRA",51
"Sergey Stechkin",1920,"1995",0," number theory","mathematician","RUS",75
"Arthur Geoffrey Walker",1900,"2001",1," physical cosmology","mathematician","CAN",101
"Alexis Clairaut",1710,"1765",1," astronomy","astronomer","CAN",55
"Julian Sochocki",1840,"1927",0," Q3968","mathematician","JAM",87
"Nicolaas Govert de Bruijn",1910,"2012",0," theoretical computer science","mathematician","NLD",102
"Andrey Markov, Jr.",1900,"1979",1," topological algebra","mathematician","RUS",79
"Vyacheslav Stepanov",1880,"1950",1," differential equation","mathematician","RUS",70
"Maryam Mirzakhani",1970,"2017",1," ergodic theory","mathematician","IRN",47
"Leonid Kantorovich",1910,"1986",1," Function theory","mathematician","RUS",76
"Nikolai Nikolaevich Yanenko",1920,"1984",1," differential geometry","mathematician","ARM",64
"Kazimierz Ajdukiewicz",1890,"1963",0," analytic philosophy","philosopher","UKR",73
"Nikolai Nikolayevich Vorobyov (mathematician)",1920,"1995",0," game theory","mathematician","RUS",75
"Konstantin Andreev",1840,"1921",0," differential equation","mathematician","RUS",81
"Sergei Fomin",1910,"1975",0," Lie group","mathematician","RUS",65
"Jakob Hermann",1670,"1733",0," geometry","mathematician","BEL",63
"Boris Moishezon",1930,"1993",1," number theory","mathematician","UKR",63
"Pierre-Simon Laplace",1740,"1827",1," mathematical analysis","mathematician","FRA",87
"Georgiy Shilov",1910,"1975",1," differential equation","mathematician","BGR",65
"Oleg Lupanov",1930,"2006",1," cybernetics","mathematician","RUS",76
"Boris Delaunay",1890,"1980",1," crystallography","mathematician","RUS",90
"Carl Friedrich Gauss",1770,"1855",1," mathematical analysis","mathematician","AUS",85
"John Forbes Nash Jr.",1920,"2015",1," differential geometry","mathematician","USA",95
"Renato Caccioppoli",1900,"1959",0," partial differential equation","mathematician","ITA",59
"Aleksandr Nekrasov",1880,"1957",1," integral equation","mathematician","RUS",77
"Roland Dobrushin",1920,"1995",0," information theory","mathematician","RUS",75
"Boris Yakovlevich Bukreev",1850,"1962",1," calculus of variations","mathematician","RUS",112
"Paul Émile Appell",1850,"1930",1," mechanics","mathematician","BEL",80
"Viktor Vladimirovich Nemytskii",1900,"1967",1," topology","mathematician","RUS",67
"Andrey Markov",1850,"1922",1," number theory","mathematician","RUS",72
"Vasili Yakovlevich Zinger",1830,"1907",0," philosophy","philosopher","RUS",77
"Samuel Karlin",1920,"2007",1," game theory","mathematician","USA",87
"Alfréd Rényi",1920,"1970",1," graph theory","mathematician","HUN",50
"Ivan Petrovsky",1900,"1973",1," algebraic geometry","mathematician","RUS",73
"Vladimir Arnold",1930,"2010",1," differential calculus","mathematician","UKR",80
"Galileo Galilei",1560,"1642",0," mechanics","astronomer","COL",82
"Pelageya Polubarinova-Kochina",1890,"1999",1," history of mathematics","mathematician","KAZ",109
"Nikolay Mitrofanovich Krylov",1870,"1955",1," mathematical physics","mathematician","RUS",85
"Vyacheslav Ivanovich Lebedev",1930,"2010",1," functional analysis","mathematician","RUS",80
"James Hopwood Jeans",1870,"1946",1," mathematics","mathematician","GBR",76
"Dmitri Anosov",1930,"2014",1," topology","mathematician","RUS",84
"Olga Ladyzhenskaya",1920,"2004",1," differential equation","mathematician","RUS",84
"Alexander Friedmann",1880,"1925",1," dynamic meteorology","mathematician","RUS",45
"Vitalii Ditkin",1910,"1987",1," mathematical analysis","mathematician","RUS",77
"Anatoly Maltsev",1900,"1967",1," Lie algebra","mathematician","RUS",67
"Alexander Ostrowski",1890,"1986",0," functional analysis","mathematician","RUS",96
"Michel Deza",1930,"2016",0," geometry","mathematician","RUS",86
"Baha<U+02BE> al-din al-<U+02BF>Amili",1540,"1622",0," philosopher","mathematician","LBN",82
"James Clerk Maxwell",1830,"1879",1," mechanics","physicist","GBR",49
"András Hajnal",1930,"2016",0," set theory","mathematician","HUN",86
"Ferdinand Georg Frobenius",1840,"1917",0," topology","mathematician","DEU",77
"Joseph Bertrand",1820,"1900",1," number theory","mathematician","CAN",80
"Ferdinand Minding",1800,"1885",1," Q3968","mathematician","POL",85
"Ilya Piatetski-Shapiro",1920,"2009",1," representation theory","mathematician","RUS",89
"Nikita Moiseyev",1910,"2000",1," control theory","mathematician","RUS",90
"Boris Koyalovich",1860,"1941",0," analytic geometry","mathematician","RUS",81
"Pavel Alexandrov",1890,"1982",1," geometry","mathematician","RUS",92
"Ervand Kogbetliantz",1880,"1974",0," mathematical analysis","mathematician","RUS",94
"Charles Babbage",1790,"1871",1," computer science","mathematician","BLZ",81
"Anatoli Georgievich Vitushkin",1930,"2004",1," complex geometry","mathematician","RUS",74
"E. H. Moore",1860,"1932",0," mathematical analysis","mathematician","USA",72
"Dmitri Egorov",1860,"1931",1," calculus of variations","mathematician","RUS",71
"Aleksandr Lyapunov",1850,"1918",0," probability theory","mathematician","RUS",68
"Lazarus Fuchs",1830,"1902",1," calculus of variations","mathematician","ITA",72
"Emmy Noether",1880,"1935",1," theoretical physics","mathematician","DEU",55
"Aleksandr Khinchin",1890,"1959",1," queueing theory","mathematician","RUS",69
"Sergei Sobolev",1900,"1989",1," differential calculus","mathematician","RUS",89
"Sergey Mergelyan",1920,"2008",1," approximation theory","mathematician","UKR",88
"Margherita Piazzola Beloch",1870,"1976",0," photogrammetry","mathematician","ITA",106
"L. E. J. Brouwer",1880,"1966",1," set theory","mathematician","NLD",86
"Paul Erdos",1910,"1996",1," graph theory","mathematician","HUN",86
"Leonhard Euler",1700,"1783",0," cartography","mathematician","BEL",83
"Corrado Gini",1880,"1965",0," demography","economist","ITA",85
"Gilles de Roberval",1600,"1675",0," astronomy","philosopher","FRA",75
"Semyon Aranovich Gershgorin",1900,"1933",0," differential equation","mathematician","BLR",33
"Christiaan Huygens",1620,"1695",0," physics","astronomer","NLD",75
"Lyudmila Keldysh",1900,"1976",1," topology","mathematician","RUS",76
"Nikolai Günther",1870,"1941",1," Function theory","mathematician","RUS",71
"Vladimir Abramovich Rokhlin",1910,"1984",0," measure theory","mathematician","AZE",74
"Andrey Kolmogorov",1900,"1987",1," geometry","mathematician","RUS",87
"Sergey Chaplygin",1860,"1942",1," physics","mathematician","RUS",82
"Nicolaus II Bernoulli",1690,"1726",0," differential calculus","mathematician","BEL",36
"Lev Pontryagin",1900,"1988",1," calculus of variations","mathematician","RUS",88
"Pyotr Novikov",1900,"1975",1," mathematical logic","mathematician","RUS",75
"Pál Turán",1910,"1976",1," number theory","mathematician","HUN",66
"François Viète",1540,"1603",0," geometry","mathematician","FRA",63
"Johann Christian Martin Bartels",1760,"1836",0," geometry","mathematician","AUS",76
"Alan Turing",1910,"1954",1," mathematics","computer scientist","GBR",44
"Mark Krein",1900,"1989",1," integral equation","mathematician","RUS",89
"Dmitry Grave",1860,"1939",1," group theory","mathematician","RUS",79
"Boris Demidovich",1900,"1977",1," functional analysis","mathematician","BLR",77
"Josif Shtokalo",1890,"1987",1," mathematics","mathematician","UKR",97
"Boris Galerkin",1870,"1945",1," Structural mechanics","mathematician","BLR",75
"Gilbert Hunt",1910,"2008",0," potential theory","tennis player","ARG",98
"James Joseph Sylvester",1810,"1897",1," number theory","mathematician","BLZ",87
"Mikhail Lavrentyev",1900,"1980",1," mathematical physics","mathematician","AFG",80
"Fridrikh Karpelevich",1920,"2000",0," queueing theory","mathematician","RUS",80
"Alexey Lyapunov",1910,"1973",1," Function theory","mathematician","RUS",63
"Israel Gelfand",1910,"2009",1," Q3968","mathematician","UKR",99
"Thomas Kirkman",1800,"1895",1," group theory","mathematician","AUS",95
"Maurice René Fréchet",1870,"1973",1," probability theory","mathematician","FRA",103
"Georges-Louis Leclerc, Comte de Buffon",1700,"1788",1," geology","botanist","FRA",88
"Grigorii Fichtenholz",1880,"1959",1," functional analysis","mathematician","UKR",79
"Douglas Hartree",1890,"1958",1," atomic physics","mathematician","AUS",68
"Mikhail Postnikov",1920,"2004",1," algebraic topology","mathematician","RUS",84
"Ralph Faudree",1930,"2015",1," Ramsey theory","mathematician","BRB",85
"Igor Shafarevich",1920,"2017",1," Q3968","mathematician","UKR",97
"Willard Van Orman Quine",1900,"2000",1," ontology","mathematician","USA",100
"Pavel Urysohn",1890,"1924",0," geometry","mathematician","UKR",34
"Nicolas Fuss",1750,"1826",0," geometry","mathematician","BEL",76
"Adam Olearius",1600,"1671",0," history","mathematician","DEU",71
"Naum Akhiezer",1900,"1980",0," approximation theory","mathematician","BLR",80
"Sergei Natanovich Bernstein",1880,"1968",1," probability theory","mathematician","UKR",88
"Naum Ya. Vilenkin",1920,"1991",0," topology","mathematician","RUS",71
"Sofia Kovalevskaya",1850,"1891",1," differential calculus","mathematician","RUS",41
"Israel Gohberg",1920,"2009",0," geometry","mathematician","UKR",89
"Valery Glivenko",1890,"1940",0," mathematical statistics","mathematician","RUS",50
"Jean Leray",1900,"1998",1," topology","mathematician","BRA",98
"Georgii Evgenevich Shilov",1910,"1975",1," differential equation","mathematician","BGR",65
"Henri Poincaré",1850,"1912",1," geometry","mathematician","BOL",62
"Daniel Bernoulli",1700,"1782",1," differential calculus","mathematician","NLD",82
"Abram Ilyich Fet",1920,"2007",0," calculus of variations","mathematician","UKR",87
"Paul Halmos",1910,"2006",1," functional analysis","mathematician","HUN",96
"Isaac Barrow",1630,"1677",0," theology"," mathematician","BLZ",47
"Anatoly Karatsuba",1930,"2008",1," physics"," university teacher","RUS",78
"Jarl Waldemar Lindeberg",1870,"1932",0," mathematical statistics"," statistician","FIN",62
"Felix Berezin",1930,"1980",0," geometry"," physicist","RUS",50
"Sergey Nikolsky",1900,"2012",1," differential equation"," university teacher","RUS",112
"Yuri Linnik",1910,"1972",1," probability theory"," statistician","UKR",62
"Viktor Bunyakovsky",1800,"1889",0," probability theory"," teacher","AFG",89
"Andrei Bolibrukh",1950,"2003",0," topology"," university teacher","RUS",53
"Arthur Milgram",1910,"1961",0," differential geometry"," topologist","BRA",51
"Sergey Stechkin",1920,"1995",0," number theory"," university teacher","RUS",75
"Arthur Geoffrey Walker",1900,"2001",1," physical cosmology"," physicist","CAN",101
"Alexis Clairaut",1710,"1765",1," astronomy"," mathematician","CAN",55
"Nicolaas Govert de Bruijn",1910,"2012",0," theoretical computer science"," university teacher","NLD",102
"Andrey Markov, Jr.",1900,"1979",1," topological algebra"," topologist","RUS",79
"Vyacheslav Stepanov",1880,"1950",1," differential equation"," university teacher","RUS",70
"Maryam Mirzakhani",1970,"2017",1," ergodic theory"," topologist","IRN",47
"Leonid Kantorovich",1910,"1986",1," Function theory"," economist","RUS",76
"Kazimierz Ajdukiewicz",1890,"1963",0," analytic philosophy"," educator","UKR",73
"Sergei Fomin",1910,"1975",0," Lie group"," university teacher","RUS",65
"Jakob Hermann",1670,"1733",0," geometry"," university teacher","BEL",63
"Pierre-Simon Laplace",1740,"1827",1," mathematical analysis"," astronomer","FRA",87
"Oleg Lupanov",1930,"2006",1," cybernetics"," computer scientist","RUS",76
"Boris Delaunay",1890,"1980",1," crystallography"," university teacher","RUS",90
"Carl Friedrich Gauss",1770,"1855",1," mathematical analysis"," geophysicist","AUS",85
"John Forbes Nash Jr.",1920,"2015",1," differential geometry"," economist","USA",95
"Renato Caccioppoli",1900,"1959",0," partial differential equation"," university teacher","ITA",59
"Roland Dobrushin",1920,"1995",0," information theory"," physicist","RUS",75
"Paul Émile Appell",1850,"1930",1," mechanics"," university teacher","BEL",80
"Andrey Markov",1850,"1922",1," number theory"," statistician","RUS",72
"Vasili Yakovlevich Zinger",1830,"1907",0," philosophy"," botanist","RUS",77
"Samuel Karlin",1920,"2007",1," game theory"," statistician","USA",87
"Alfréd Rényi",1920,"1970",1," graph theory"," university teacher","HUN",50
"Ivan Petrovsky",1900,"1973",1," algebraic geometry"," university teacher","RUS",73
"Vladimir Arnold",1930,"2010",1," differential calculus"," topologist","UKR",80
"Galileo Galilei",1560,"1642",0," mechanics"," philosopher","COL",82
"Pelageya Polubarinova-Kochina",1890,"1999",1," history of mathematics"," historian of mathematics","KAZ",109
"Nikolay Mitrofanovich Krylov",1870,"1955",1," mathematical physics"," physicist","RUS",85
"Vyacheslav Ivanovich Lebedev",1930,"2010",1," functional analysis"," university teacher","RUS",80
"James Hopwood Jeans",1870,"1946",1," mathematics"," physicist","GBR",76
"Olga Ladyzhenskaya",1920,"2004",1," differential equation"," university teacher","RUS",84
"Alexander Friedmann",1880,"1925",1," dynamic meteorology"," physicist","RUS",45
"Alexander Ostrowski",1890,"1986",0," functional analysis"," university teacher","RUS",96
"Baha<U+02BE> al-din al-<U+02BF>Amili",1540,"1622",0," philosopher"," scientist","LBN",82
"James Clerk Maxwell",1830,"1879",1," mechanics"," mathematician","GBR",49
"Ferdinand Georg Frobenius",1840,"1917",0," topology"," university teacher","DEU",77
"Joseph Bertrand",1820,"1900",1," number theory"," economist","CAN",80
"Ferdinand Minding",1800,"1885",1," Q3968"," university teacher","POL",85
"Ilya Piatetski-Shapiro",1920,"2009",1," representation theory"," educator","RUS",89
"Boris Koyalovich",1860,"1941",0," analytic geometry"," chess player","RUS",81
"Pavel Alexandrov",1890,"1982",1," geometry"," university teacher","RUS",92
"Charles Babbage",1790,"1871",1," computer science"," computer scientist","BLZ",81
"Anatoli Georgievich Vitushkin",1930,"2004",1," complex geometry"," computer scientist","RUS",74
"Dmitri Egorov",1860,"1931",1," calculus of variations"," university teacher","RUS",71
"Aleksandr Lyapunov",1850,"1918",0," probability theory"," physicist","RUS",68
"Lazarus Fuchs",1830,"1902",1," calculus of variations"," teacher","ITA",72
"Emmy Noether",1880,"1935",1," theoretical physics"," physicist","DEU",55
"Sergei Sobolev",1900,"1989",1," differential calculus"," university teacher","RUS",89
"Sergey Mergelyan",1920,"2008",1," approximation theory"," scientist","UKR",88
"Margherita Piazzola Beloch",1870,"1976",0," photogrammetry"," university teacher","ITA",106
"L. E. J. Brouwer",1880,"1966",1," set theory"," philosopher","NLD",86
"Leonhard Euler",1700,"1783",0," cartography"," physicist","BEL",83
"Corrado Gini",1880,"1965",0," demography"," statistician","ITA",85
"Gilles de Roberval",1600,"1675",0," astronomy"," mathematician","FRA",75
"Christiaan Huygens",1620,"1695",0," physics"," mathematician","NLD",75
"Nikolai Günther",1870,"1941",1," Function theory"," university teacher","RUS",71
"Vladimir Abramovich Rokhlin",1910,"1984",0," measure theory"," topologist","AZE",74
"Andrey Kolmogorov",1900,"1987",1," geometry"," computer scientist","RUS",87
"Sergey Chaplygin",1860,"1942",1," physics"," physicist","RUS",82
"Nicolaus II Bernoulli",1690,"1726",0," differential calculus"," university teacher","BEL",36
"Pál Turán",1910,"1976",1," number theory"," university teacher","HUN",66
"François Viète",1540,"1603",0," geometry"," cryptographer","FRA",63
"Johann Christian Martin Bartels",1760,"1836",0," geometry"," educator","AUS",76
"Alan Turing",1910,"1954",1," mathematics"," mathematician","GBR",44
"Mark Krein",1900,"1989",1," integral equation"," university teacher","RUS",89
"Boris Galerkin",1870,"1945",1," Structural mechanics"," engineer","BLR",75
"Gilbert Hunt",1910,"2008",0," potential theory"," mathematician","ARG",98
"James Joseph Sylvester",1810,"1897",1," number theory"," actuary","BLZ",87
"Mikhail Lavrentyev",1900,"1980",1," mathematical physics"," physicist","AFG",80
"Alexey Lyapunov",1910,"1973",1," Function theory"," computer scientist","RUS",63
"Israel Gelfand",1910,"2009",1," Q3968"," biologist","UKR",99
"Thomas Kirkman",1800,"1895",1," group theory"," topologist","AUS",95
"Maurice René Fréchet",1870,"1973",1," probability theory"," Esperantist","FRA",103
"Georges-Louis Leclerc, Comte de Buffon",1700,"1788",1," geology"," volcanologist","FRA",88
"Grigorii Fichtenholz",1880,"1959",1," functional analysis"," university teacher","UKR",79
"Douglas Hartree",1890,"1958",1," atomic physics"," physicist","AUS",68
"Mikhail Postnikov",1920,"2004",1," algebraic topology"," topologist","RUS",84
"Ralph Faudree",1930,"2015",1," Ramsey theory"," university teacher","BRB",85
"Igor Shafarevich",1920,"2017",1," Q3968"," human rights activist","UKR",97
"Willard Van Orman Quine",1900,"2000",1," ontology"," analytic philosopher","USA",100
"Pavel Urysohn",1890,"1924",0," geometry"," topologist","UKR",34
"Adam Olearius",1600,"1671",0," history"," linguist","DEU",71
"Sergei Natanovich Bernstein",1880,"1968",1," probability theory"," university teacher","UKR",88
"Sofia Kovalevskaya",1850,"1891",1," differential calculus"," physicist","RUS",41
"Israel Gohberg",1920,"2009",0," geometry"," university teacher","UKR",89
"Jean Leray",1900,"1998",1," topology"," topologist","BRA",98
"Henri Poincaré",1850,"1912",1," geometry"," philosopher","BOL",62
"Daniel Bernoulli",1700,"1782",1," differential calculus"," physicist","NLD",82
"Abram Ilyich Fet",1920,"2007",0," calculus of variations"," topologist","UKR",87
"Paul Halmos",1910,"2006",1," functional analysis"," philosopher","HUN",96
"Isaac Barrow",1630,"1677",0," theology"," historian of mathematics","BLZ",47
"Felix Berezin",1930,"1980",0," geometry"," inventor","RUS",50
"Yuri Linnik",1910,"1972",1," probability theory"," university teacher","UKR",62
"Arthur Geoffrey Walker",1900,"2001",1," physical cosmology"," university teacher","CAN",101
"Alexis Clairaut",1710,"1765",1," astronomy"," mechanic","CAN",55
"Nicolaas Govert de Bruijn",1910,"2012",0," theoretical computer science"," computer scientist","NLD",102
"Andrey Markov, Jr.",1900,"1979",1," topological algebra"," university teacher","RUS",79
"Leonid Kantorovich",1910,"1986",1," Function theory"," university teacher","RUS",76
"Kazimierz Ajdukiewicz",1890,"1963",0," analytic philosophy"," translator","UKR",73
"Pierre-Simon Laplace",1740,"1827",1," mathematical analysis"," physicist","FRA",87
"Carl Friedrich Gauss",1770,"1855",1," mathematical analysis"," astronomer","AUS",85
"John Forbes Nash Jr.",1920,"2015",1," differential geometry"," university teacher","USA",95
"Paul Émile Appell",1850,"1930",1," mechanics"," scientist","BEL",80
"Andrey Markov",1850,"1922",1," number theory"," university teacher","RUS",72
"Vasili Yakovlevich Zinger",1830,"1907",0," philosophy"," mathematician","RUS",77
"Samuel Karlin",1920,"2007",1," game theory"," geneticist","USA",87
"Vladimir Arnold",1930,"2010",1," differential calculus"," professor","UKR",80
"Galileo Galilei",1560,"1642",0," mechanics"," mathematician","COL",82
"Nikolay Mitrofanovich Krylov",1870,"1955",1," mathematical physics"," university teacher","RUS",85
"James Hopwood Jeans",1870,"1946",1," mathematics"," astronomer","GBR",76
"Baha<U+02BE> al-din al-<U+02BF>Amili",1540,"1622",0," philosopher"," astronomer","LBN",82
"James Clerk Maxwell",1830,"1879",1," mechanics"," engineer","GBR",49
"Joseph Bertrand",1820,"1900",1," number theory"," professor","CAN",80
"Charles Babbage",1790,"1871",1," computer science"," engineer","BLZ",81
"Anatoli Georgievich Vitushkin",1930,"2004",1," complex geometry"," university teacher","RUS",74
"Lazarus Fuchs",1830,"1902",1," calculus of variations"," university teacher","ITA",72
"Emmy Noether",1880,"1935",1," theoretical physics"," university teacher","DEU",55
"L. E. J. Brouwer",1880,"1966",1," set theory"," topologist","NLD",86
"Leonhard Euler",1700,"1783",0," cartography"," musicologist","BEL",83
"Corrado Gini",1880,"1965",0," demography"," sociologist","ITA",85
"Gilles de Roberval",1600,"1675",0," astronomy"," professor","FRA",75
"Christiaan Huygens",1620,"1695",0," physics"," physicist","NLD",75
"Vladimir Abramovich Rokhlin",1910,"1984",0," measure theory"," university teacher","AZE",74
"Andrey Kolmogorov",1900,"1987",1," geometry"," statistician","RUS",87
"Sergey Chaplygin",1860,"1942",1," physics"," engineer","RUS",82
"François Viète",1540,"1603",0," geometry"," lawyer","FRA",63
"Alan Turing",1910,"1954",1," mathematics"," university teacher","GBR",44
"James Joseph Sylvester",1810,"1897",1," number theory"," university teacher","BLZ",87
"Mikhail Lavrentyev",1900,"1980",1," mathematical physics"," university teacher","AFG",80
"Israel Gelfand",1910,"2009",1," Q3968"," university teacher","UKR",99
"Maurice René Fréchet",1870,"1973",1," probability theory"," statistician","FRA",103
"Georges-Louis Leclerc, Comte de Buffon",1700,"1788",1," geology"," ornithologist","FRA",88
"Douglas Hartree",1890,"1958",1," atomic physics"," professor","AUS",68
"Mikhail Postnikov",1920,"2004",1," algebraic topology"," university teacher","RUS",84
"Igor Shafarevich",1920,"2017",1," Q3968"," university teacher","UKR",97
"Willard Van Orman Quine",1900,"2000",1," ontology"," philosopher of language","USA",100
"Adam Olearius",1600,"1671",0," history"," librarian","DEU",71
"Sofia Kovalevskaya",1850,"1891",1," differential calculus"," scientist","RUS",41
"Jean Leray",1900,"1998",1," topology"," professor","BRA",98
"Henri Poincaré",1850,"1912",1," geometry"," astronomer","BOL",62
"Daniel Bernoulli",1700,"1782",1," differential calculus"," university teacher","NLD",82
"Paul Halmos",1910,"2006",1," functional analysis"," statistician","HUN",96
"Isaac Barrow",1630,"1677",0," theology"," physicist","BLZ",47
"Alexis Clairaut",1710,"1765",1," astronomy"," physicist","CAN",55
"Leonid Kantorovich",1910,"1986",1," Function theory"," scientist","RUS",76
"Kazimierz Ajdukiewicz",1890,"1963",0," analytic philosophy"," university teacher","UKR",73
"Pierre-Simon Laplace",1740,"1827",1," mathematical analysis"," politician","FRA",87
"Carl Friedrich Gauss",1770,"1855",1," mathematical analysis"," science writer","AUS",85
"Vasili Yakovlevich Zinger",1830,"1907",0," philosophy"," university teacher","RUS",77
"Samuel Karlin",1920,"2007",1," game theory"," university teacher","USA",87
"Vladimir Arnold",1930,"2010",1," differential calculus"," scientist","UKR",80
"Galileo Galilei",1560,"1642",0," mechanics"," physicist","COL",82
"James Hopwood Jeans",1870,"1946",1," mathematics"," writer","GBR",76
"Baha<U+02BE> al-din al-<U+02BF>Amili",1540,"1622",0," philosopher"," writer","LBN",82
"James Clerk Maxwell",1830,"1879",1," mechanics"," inventor","GBR",49
"Charles Babbage",1790,"1871",1," computer science"," economist","BLZ",81
"L. E. J. Brouwer",1880,"1966",1," set theory"," university teacher","NLD",86
"Leonhard Euler",1700,"1783",0," cartography"," music theorist","BEL",83
"Corrado Gini",1880,"1965",0," demography"," demographer","ITA",85
"Gilles de Roberval",1600,"1675",0," astronomy"," physicist","FRA",75
"Christiaan Huygens",1620,"1695",0," physics"," musicologist","NLD",75
"Andrey Kolmogorov",1900,"1987",1," geometry"," university teacher","RUS",87
"Alan Turing",1910,"1954",1," mathematics"," cryptographer","GBR",44
"Maurice René Fréchet",1870,"1973",1," probability theory"," university teacher","FRA",103
"Georges-Louis Leclerc, Comte de Buffon",1700,"1788",1," geology"," scientist","FRA",88
"Douglas Hartree",1890,"1958",1," atomic physics"," computer scientist","AUS",68
"Willard Van Orman Quine",1900,"2000",1," ontology"," epistemologist","USA",100
"Adam Olearius",1600,"1671",0," history"," diplomat","DEU",71
"Sofia Kovalevskaya",1850,"1891",1," differential calculus"," novelist","RUS",41
"Henri Poincaré",1850,"1912",1," geometry"," physicist","BOL",62
"Daniel Bernoulli",1700,"1782",1," differential calculus"," economist","NLD",82
"Isaac Barrow",1630,"1677",0," theology"," university teacher","BLZ",47
"Kazimierz Ajdukiewicz",1890,"1963",0," analytic philosophy"," mathematician","UKR",73
"Pierre-Simon Laplace",1740,"1827",1," mathematical analysis"," philosopher","FRA",87
"Carl Friedrich Gauss",1770,"1855",1," mathematical analysis"," physicist","AUS",85
"Galileo Galilei",1560,"1642",0," mechanics"," inventor","COL",82
"James Hopwood Jeans",1870,"1946",1," mathematics"," university teacher","GBR",76
"Baha<U+02BE> al-din al-<U+02BF>Amili",1540,"1622",0," philosopher"," architect","LBN",82
"James Clerk Maxwell",1830,"1879",1," mechanics"," photographer","GBR",49
"Charles Babbage",1790,"1871",1," computer science"," philosopher","BLZ",81
"Leonhard Euler",1700,"1783",0," cartography"," university teacher","BEL",83
"Christiaan Huygens",1620,"1695",0," physics"," inventor","NLD",75
"Alan Turing",1910,"1954",1," mathematics"," logician","GBR",44
"Georges-Louis Leclerc, Comte de Buffon",1700,"1788",1," geology"," mathematician","FRA",88
"Willard Van Orman Quine",1900,"2000",1," ontology"," philosopher of science","USA",100
"Adam Olearius",1600,"1671",0," history"," translator","DEU",71
"Sofia Kovalevskaya",1850,"1891",1," differential calculus"," university teacher","RUS",41
"Henri Poincaré",1850,"1912",1," geometry"," engineer","BOL",62
"Pierre-Simon Laplace",1740,"1827",1," mathematical analysis"," university teacher","FRA",87
"Carl Friedrich Gauss",1770,"1855",1," mathematical analysis"," geodesist","AUS",85
"Galileo Galilei",1560,"1642",0," mechanics"," astrologer","COL",82
"Baha<U+02BE> al-din al-<U+02BF>Amili",1540,"1622",0," philosopher"," astrologer","LBN",82
"James Clerk Maxwell",1830,"1879",1," mechanics"," university teacher","GBR",49
"Charles Babbage",1790,"1871",1," computer science"," professor","BLZ",81
"Leonhard Euler",1700,"1783",0," cartography"," writer","BEL",83
"Christiaan Huygens",1620,"1695",0," physics"," music theorist","NLD",75
"Alan Turing",1910,"1954",1," mathematics"," philosopher","GBR",44
"Georges-Louis Leclerc, Comte de Buffon",1700,"1788",1," geology"," writer","FRA",88
"Willard Van Orman Quine",1900,"2000",1," ontology"," university teacher","USA",100
"Adam Olearius",1600,"1671",0," history"," writer","DEU",71
"Sofia Kovalevskaya",1850,"1891",1," differential calculus"," writer","RUS",41
"Henri Poincaré",1850,"1912",1," geometry"," philosopher of science","BOL",62
"Pierre-Simon Laplace",1740,"1827",1," mathematical analysis"," theoretical physicist","FRA",87
"Carl Friedrich Gauss",1770,"1855",1," mathematical analysis"," university teacher","AUS",85
"Galileo Galilei",1560,"1642",0," mechanics"," polymath","COL",82
"James Clerk Maxwell",1830,"1879",1," mechanics"," theoretical physicist","GBR",49
"Leonhard Euler",1700,"1783",0," cartography"," teacher","BEL",83
"Christiaan Huygens",1620,"1695",0," physics"," theoretical physicist","NLD",75
"Alan Turing",1910,"1954",1," mathematics"," artificial intelligence researcher","GBR",44
"Georges-Louis Leclerc, Comte de Buffon",1700,"1788",1," geology"," naturalist","FRA",88
"Willard Van Orman Quine",1900,"2000",1," ontology"," professor","USA",100
"Adam Olearius",1600,"1671",0," history"," poet lawyer","DEU",71
"Henri Poincaré",1850,"1912",1," geometry"," topologist","BOL",62
"Galileo Galilei",1560,"1642",0," mechanics"," university teacher","COL",82
"Georges-Louis Leclerc, Comte de Buffon",1700,"1788",1," geology"," zoologist","FRA",88
"Willard Van Orman Quine",1900,"2000",1," ontology"," philosopher","USA",100
"Adam Olearius",1600,"1671",0," history"," historian","DEU",71
"Henri Poincaré",1850,"1912",1," geometry"," university teacher","BOL",62
"Galileo Galilei",1560,"1642",0," mechanics"," scientist","COL",82
"Georges-Louis Leclerc, Comte de Buffon",1700,"1788",1," geology"," philosopher","FRA",88
"Galileo Galilei",1560,"1642",0," mechanics"," theoretical physicist","COL",82
"D. D. Morduhai-Boltovskoi",1870,"1952",0," differential geometry","mathematician","KAZ",82
"Jarl Waldemar Lindeberg",1870,"1932",0," calculus of variations","mathematician","FIN",62
"Felix Berezin",1930,"1980",0," Lie algebra","mathematician","RUS",50
"Sergey Nikolsky",1900,"2012",1," complex analysis","mathematician","RUS",112
"Victor Lidskii",1920,"2008",1," operator theory","mathematician","UKR",88
"Arthur Milgram",1910,"1961",0," topology","mathematician","BRA",51
"Sergey Stechkin",1920,"1995",0," mathematical optimization","mathematician","RUS",75
"Alexis Clairaut",1710,"1765",1," geodesy","astronomer","CAN",55
"Maryam Mirzakhani",1970,"2017",1," symplectic geometry","mathematician","IRN",47
"Leonid Kantorovich",1910,"1986",1," set theory","mathematician","RUS",76
"Nikolai Nikolayevich Vorobyov (mathematician)",1920,"1995",0," Q3968","mathematician","RUS",75
"Konstantin Andreev",1840,"1921",0," pure mathematics","mathematician","RUS",81
"Jakob Hermann",1670,"1733",0," differential equation","mathematician","BEL",63
"Pierre-Simon Laplace",1740,"1827",1," mathematics","mathematician","FRA",87
"Georgiy Shilov",1910,"1975",1," mathematical analysis","mathematician","BGR",65
"Boris Delaunay",1890,"1980",1," geometry","mathematician","RUS",90
"Carl Friedrich Gauss",1770,"1855",1," differential geometry","mathematician","AUS",85
"Viktor Vladimirovich Nemytskii",1900,"1967",1," functional analysis","mathematician","RUS",67
"Vasili Yakovlevich Zinger",1830,"1907",0," mathematical analysis","philosopher","RUS",77
"Alfréd Rényi",1920,"1970",1," number theory","mathematician","HUN",50
"Ivan Petrovsky",1900,"1973",1," probability theory","mathematician","RUS",73
"Vladimir Arnold",1930,"2010",1," mechanics","mathematician","UKR",80
"Galileo Galilei",1560,"1642",0," philosophy","astronomer","COL",82
"Alexander Friedmann",1880,"1925",1," cosmology","mathematician","RUS",45
"Anatoly Maltsev",1900,"1967",1," mathematical logic","mathematician","RUS",67
"Baha<U+02BE> al-din al-<U+02BF>Amili",1540,"1622",0," poet","mathematician","LBN",82
"Ferdinand Minding",1800,"1885",1," calculus of variations","mathematician","POL",85
"Pavel Alexandrov",1890,"1982",1," calculus of variations","mathematician","RUS",92
"E. H. Moore",1860,"1932",0," geometry","mathematician","USA",72
"Dmitri Egorov",1860,"1931",1," Function theory","mathematician","RUS",71
"Emmy Noether",1880,"1935",1," field theory","mathematician","DEU",55
"Aleksandr Khinchin",1890,"1959",1," Function theory","mathematician","RUS",69
"Sergei Sobolev",1900,"1989",1," computational mathematics","mathematician","RUS",89
"L. E. J. Brouwer",1880,"1966",1," topology","mathematician","NLD",86
"Paul Erdos",1910,"1996",1," number theory","mathematician","HUN",86
"Leonhard Euler",1700,"1783",0," calculus of variations","mathematician","BEL",83
"Gilles de Roberval",1600,"1675",0," physics","philosopher","FRA",75
"Semyon Aranovich Gershgorin",1900,"1933",0," numerical analysis","mathematician","BLR",33
"Christiaan Huygens",1620,"1695",0," astronomy","astronomer","NLD",75
"Nikolai Günther",1870,"1941",1," functional analysis","mathematician","RUS",71
"Andrey Kolmogorov",1900,"1987",1," mathematical logic","mathematician","RUS",87
"Nicolaus II Bernoulli",1690,"1726",0," mechanics","mathematician","BEL",36
"Lev Pontryagin",1900,"1988",1," control theory","mathematician","RUS",88
"Pyotr Novikov",1900,"1975",1," theory of computation","mathematician","RUS",75
"Johann Christian Martin Bartels",1760,"1836",0," trigonometry","mathematician","AUS",76
"Alan Turing",1910,"1954",1," logic","computer scientist","GBR",44
"Mark Krein",1900,"1989",1," Function theory","mathematician","RUS",89
"Dmitry Grave",1860,"1939",1," number theory","mathematician","RUS",79
"Boris Demidovich",1900,"1977",1," mathematical physics","mathematician","BLR",77
"Alexey Lyapunov",1910,"1973",1," mathematical biology","mathematician","RUS",63
"Israel Gelfand",1910,"2009",1," topology","mathematician","UKR",99
"Thomas Kirkman",1800,"1895",1," topology","mathematician","AUS",95
"Mikhail Postnikov",1920,"2004",1," differential topology","mathematician","RUS",84
"Igor Shafarevich",1920,"2017",1," Galois theory","mathematician","UKR",97
"Nicolas Fuss",1750,"1826",0," mechanics","mathematician","BEL",76
"Adam Olearius",1600,"1671",0," mathematics","mathematician","DEU",71
"Naum Akhiezer",1900,"1980",0," Function theory","mathematician","BLR",80
"Sergei Natanovich Bernstein",1880,"1968",1," Function theory","mathematician","UKR",88
"Naum Ya. Vilenkin",1920,"1991",0," Lie group","mathematician","RUS",71
"Georgii Evgenevich Shilov",1910,"1975",1," mathematical analysis","mathematician","BGR",65
"Henri Poincaré",1850,"1912",1," topology","mathematician","BOL",62
"Daniel Bernoulli",1700,"1782",1," physics","mathematician","NLD",82
"Paul Halmos",1910,"2006",1," probability theory","mathematician","HUN",96
"Jarl Waldemar Lindeberg",1870,"1932",0," calculus of variations"," statistician","FIN",62
"Felix Berezin",1930,"1980",0," Lie algebra"," physicist","RUS",50
"Sergey Nikolsky",1900,"2012",1," complex analysis"," university teacher","RUS",112
"Arthur Milgram",1910,"1961",0," topology"," topologist","BRA",51
"Sergey Stechkin",1920,"1995",0," mathematical optimization"," university teacher","RUS",75
"Alexis Clairaut",1710,"1765",1," geodesy"," mathematician","CAN",55
"Maryam Mirzakhani",1970,"2017",1," symplectic geometry"," topologist","IRN",47
"Leonid Kantorovich",1910,"1986",1," set theory"," economist","RUS",76
"Jakob Hermann",1670,"1733",0," differential equation"," university teacher","BEL",63
"Pierre-Simon Laplace",1740,"1827",1," mathematics"," astronomer","FRA",87
"Boris Delaunay",1890,"1980",1," geometry"," university teacher","RUS",90
"Carl Friedrich Gauss",1770,"1855",1," differential geometry"," geophysicist","AUS",85
"Vasili Yakovlevich Zinger",1830,"1907",0," mathematical analysis"," botanist","RUS",77
"Alfréd Rényi",1920,"1970",1," number theory"," university teacher","HUN",50
"Ivan Petrovsky",1900,"1973",1," probability theory"," university teacher","RUS",73
"Vladimir Arnold",1930,"2010",1," mechanics"," topologist","UKR",80
"Galileo Galilei",1560,"1642",0," philosophy"," philosopher","COL",82
"Alexander Friedmann",1880,"1925",1," cosmology"," physicist","RUS",45
"Baha<U+02BE> al-din al-<U+02BF>Amili",1540,"1622",0," poet"," scientist","LBN",82
"Ferdinand Minding",1800,"1885",1," calculus of variations"," university teacher","POL",85
"Pavel Alexandrov",1890,"1982",1," calculus of variations"," university teacher","RUS",92
"Dmitri Egorov",1860,"1931",1," Function theory"," university teacher","RUS",71
"Emmy Noether",1880,"1935",1," field theory"," physicist","DEU",55
"Sergei Sobolev",1900,"1989",1," computational mathematics"," university teacher","RUS",89
"L. E. J. Brouwer",1880,"1966",1," topology"," philosopher","NLD",86
"Leonhard Euler",1700,"1783",0," calculus of variations"," physicist","BEL",83
"Gilles de Roberval",1600,"1675",0," physics"," mathematician","FRA",75
"Christiaan Huygens",1620,"1695",0," astronomy"," mathematician","NLD",75
"Nikolai Günther",1870,"1941",1," functional analysis"," university teacher","RUS",71
"Andrey Kolmogorov",1900,"1987",1," mathematical logic"," computer scientist","RUS",87
"Nicolaus II Bernoulli",1690,"1726",0," mechanics"," university teacher","BEL",36
"Johann Christian Martin Bartels",1760,"1836",0," trigonometry"," educator","AUS",76
"Alan Turing",1910,"1954",1," logic"," mathematician","GBR",44
"Mark Krein",1900,"1989",1," Function theory"," university teacher","RUS",89
"Alexey Lyapunov",1910,"1973",1," mathematical biology"," computer scientist","RUS",63
"Israel Gelfand",1910,"2009",1," topology"," biologist","UKR",99
"Thomas Kirkman",1800,"1895",1," topology"," topologist","AUS",95
"Mikhail Postnikov",1920,"2004",1," differential topology"," topologist","RUS",84
"Igor Shafarevich",1920,"2017",1," Galois theory"," human rights activist","UKR",97
"Adam Olearius",1600,"1671",0," mathematics"," linguist","DEU",71
"Sergei Natanovich Bernstein",1880,"1968",1," Function theory"," university teacher","UKR",88
"Henri Poincaré",1850,"1912",1," topology"," philosopher","BOL",62
"Daniel Bernoulli",1700,"1782",1," physics"," physicist","NLD",82
"Paul Halmos",1910,"2006",1," probability theory"," philosopher","HUN",96
"Felix Berezin",1930,"1980",0," Lie algebra"," inventor","RUS",50
"Alexis Clairaut",1710,"1765",1," geodesy"," mechanic","CAN",55
"Leonid Kantorovich",1910,"1986",1," set theory"," university teacher","RUS",76
"Pierre-Simon Laplace",1740,"1827",1," mathematics"," physicist","FRA",87
"Carl Friedrich Gauss",1770,"1855",1," differential geometry"," astronomer","AUS",85
"Vasili Yakovlevich Zinger",1830,"1907",0," mathematical analysis"," mathematician","RUS",77
"Vladimir Arnold",1930,"2010",1," mechanics"," professor","UKR",80
"Galileo Galilei",1560,"1642",0," philosophy"," mathematician","COL",82
"Baha<U+02BE> al-din al-<U+02BF>Amili",1540,"1622",0," poet"," astronomer","LBN",82
"Emmy Noether",1880,"1935",1," field theory"," university teacher","DEU",55
"L. E. J. Brouwer",1880,"1966",1," topology"," topologist","NLD",86
"Leonhard Euler",1700,"1783",0," calculus of variations"," musicologist","BEL",83
"Gilles de Roberval",1600,"1675",0," physics"," professor","FRA",75
"Christiaan Huygens",1620,"1695",0," astronomy"," physicist","NLD",75
"Andrey Kolmogorov",1900,"1987",1," mathematical logic"," statistician","RUS",87
"Alan Turing",1910,"1954",1," logic"," university teacher","GBR",44
"Israel Gelfand",1910,"2009",1," topology"," university teacher","UKR",99
"Mikhail Postnikov",1920,"2004",1," differential topology"," university teacher","RUS",84
"Igor Shafarevich",1920,"2017",1," Galois theory"," university teacher","UKR",97
"Adam Olearius",1600,"1671",0," mathematics"," librarian","DEU",71
"Henri Poincaré",1850,"1912",1," topology"," astronomer","BOL",62
"Daniel Bernoulli",1700,"1782",1," physics"," university teacher","NLD",82
"Paul Halmos",1910,"2006",1," probability theory"," statistician","HUN",96
"Alexis Clairaut",1710,"1765",1," geodesy"," physicist","CAN",55
"Leonid Kantorovich",1910,"1986",1," set theory"," scientist","RUS",76
"Pierre-Simon Laplace",1740,"1827",1," mathematics"," politician","FRA",87
"Carl Friedrich Gauss",1770,"1855",1," differential geometry"," science writer","AUS",85
"Vasili Yakovlevich Zinger",1830,"1907",0," mathematical analysis"," university teacher","RUS",77
"Vladimir Arnold",1930,"2010",1," mechanics"," scientist","UKR",80
"Galileo Galilei",1560,"1642",0," philosophy"," physicist","COL",82
"Baha<U+02BE> al-din al-<U+02BF>Amili",1540,"1622",0," poet"," writer","LBN",82
"L. E. J. Brouwer",1880,"1966",1," topology"," university teacher","NLD",86
"Leonhard Euler",1700,"1783",0," calculus of variations"," music theorist","BEL",83
"Gilles de Roberval",1600,"1675",0," physics"," physicist","FRA",75
"Christiaan Huygens",1620,"1695",0," astronomy"," musicologist","NLD",75
"Andrey Kolmogorov",1900,"1987",1," mathematical logic"," university teacher","RUS",87
"Alan Turing",1910,"1954",1," logic"," cryptographer","GBR",44
"Adam Olearius",1600,"1671",0," mathematics"," diplomat","DEU",71
"Henri Poincaré",1850,"1912",1," topology"," physicist","BOL",62
"Daniel Bernoulli",1700,"1782",1," physics"," economist","NLD",82
"Pierre-Simon Laplace",1740,"1827",1," mathematics"," philosopher","FRA",87
"Carl Friedrich Gauss",1770,"1855",1," differential geometry"," physicist","AUS",85
"Galileo Galilei",1560,"1642",0," philosophy"," inventor","COL",82
"Baha<U+02BE> al-din al-<U+02BF>Amili",1540,"1622",0," poet"," architect","LBN",82
"Leonhard Euler",1700,"1783",0," calculus of variations"," university teacher","BEL",83
"Christiaan Huygens",1620,"1695",0," astronomy"," inventor","NLD",75
"Alan Turing",1910,"1954",1," logic"," logician","GBR",44
"Adam Olearius",1600,"1671",0," mathematics"," translator","DEU",71
"Henri Poincaré",1850,"1912",1," topology"," engineer","BOL",62
"Pierre-Simon Laplace",1740,"1827",1," mathematics"," university teacher","FRA",87
"Carl Friedrich Gauss",1770,"1855",1," differential geometry"," geodesist","AUS",85
"Galileo Galilei",1560,"1642",0," philosophy"," astrologer","COL",82
"Baha<U+02BE> al-din al-<U+02BF>Amili",1540,"1622",0," poet"," astrologer","LBN",82
"Leonhard Euler",1700,"1783",0," calculus of variations"," writer","BEL",83
"Christiaan Huygens",1620,"1695",0," astronomy"," music theorist","NLD",75
"Alan Turing",1910,"1954",1," logic"," philosopher","GBR",44
"Adam Olearius",1600,"1671",0," mathematics"," writer","DEU",71
"Henri Poincaré",1850,"1912",1," topology"," philosopher of science","BOL",62
"Pierre-Simon Laplace",1740,"1827",1," mathematics"," theoretical physicist","FRA",87
"Carl Friedrich Gauss",1770,"1855",1," differential geometry"," university teacher","AUS",85
"Galileo Galilei",1560,"1642",0," philosophy"," polymath","COL",82
"Leonhard Euler",1700,"1783",0," calculus of variations"," teacher","BEL",83
"Christiaan Huygens",1620,"1695",0," astronomy"," theoretical physicist","NLD",75
"Alan Turing",1910,"1954",1," logic"," artificial intelligence researcher","GBR",44
"Adam Olearius",1600,"1671",0," mathematics"," poet lawyer","DEU",71
"Henri Poincaré",1850,"1912",1," topology"," topologist","BOL",62
"Galileo Galilei",1560,"1642",0," philosophy"," university teacher","COL",82
"Adam Olearius",1600,"1671",0," mathematics"," historian","DEU",71
"Henri Poincaré",1850,"1912",1," topology"," university teacher","BOL",62
"Galileo Galilei",1560,"1642",0," philosophy"," scientist","COL",82
"Galileo Galilei",1560,"1642",0," philosophy"," theoretical physicist","COL",82
"D. D. Morduhai-Boltovskoi",1870,"1952",0," differential equation","mathematician","KAZ",82
"Felix Berezin",1930,"1980",0," group theory","mathematician","RUS",50
"Maryam Mirzakhani",1970,"2017",1," complex geometry","mathematician","IRN",47
"Nikolai Nikolayevich Vorobyov (mathematician)",1920,"1995",0," probability theory","mathematician","RUS",75
"Pierre-Simon Laplace",1740,"1827",1," mechanics","mathematician","FRA",87
"Boris Delaunay",1890,"1980",1," Q3968","mathematician","RUS",90
"Carl Friedrich Gauss",1770,"1855",1," electrostatics","mathematician","AUS",85
"Vasili Yakovlevich Zinger",1830,"1907",0," Q3968","philosopher","RUS",77
"Ivan Petrovsky",1900,"1973",1," mathematical physics","mathematician","RUS",73
"Galileo Galilei",1560,"1642",0," mathematics","astronomer","COL",82
"Alexander Friedmann",1880,"1925",1," mathematics","mathematician","RUS",45
"Anatoly Maltsev",1900,"1967",1," group theory","mathematician","RUS",67
"Pavel Alexandrov",1890,"1982",1," mathematical logic","mathematician","RUS",92
"E. H. Moore",1860,"1932",0," number theory","mathematician","USA",72
"Sergei Sobolev",1900,"1989",1," distribution function (physics)","mathematician","RUS",89
"Leonhard Euler",1700,"1783",0," astronomy","mathematician","BEL",83
"Andrey Kolmogorov",1900,"1987",1," mechanics","mathematician","RUS",87
"Mark Krein",1900,"1989",1," Q3968","mathematician","RUS",89
"Dmitry Grave",1860,"1939",1," Q3968","mathematician","RUS",79
"Israel Gelfand",1910,"2009",1," theory of differential equations","mathematician","UKR",99
"Nicolas Fuss",1750,"1826",0," trigonometry","mathematician","BEL",76
"Adam Olearius",1600,"1671",0," physics","mathematician","DEU",71
"Paul Halmos",1910,"2006",1," set theory","mathematician","HUN",96
"Felix Berezin",1930,"1980",0," group theory"," physicist","RUS",50
"Maryam Mirzakhani",1970,"2017",1," complex geometry"," topologist","IRN",47
"Pierre-Simon Laplace",1740,"1827",1," mechanics"," astronomer","FRA",87
"Boris Delaunay",1890,"1980",1," Q3968"," university teacher","RUS",90
"Carl Friedrich Gauss",1770,"1855",1," electrostatics"," geophysicist","AUS",85
"Vasili Yakovlevich Zinger",1830,"1907",0," Q3968"," botanist","RUS",77
"Ivan Petrovsky",1900,"1973",1," mathematical physics"," university teacher","RUS",73
"Galileo Galilei",1560,"1642",0," mathematics"," philosopher","COL",82
"Alexander Friedmann",1880,"1925",1," mathematics"," physicist","RUS",45
"Pavel Alexandrov",1890,"1982",1," mathematical logic"," university teacher","RUS",92
"Sergei Sobolev",1900,"1989",1," distribution function (physics)"," university teacher","RUS",89
"Leonhard Euler",1700,"1783",0," astronomy"," physicist","BEL",83
"Andrey Kolmogorov",1900,"1987",1," mechanics"," computer scientist","RUS",87
"Mark Krein",1900,"1989",1," Q3968"," university teacher","RUS",89
"Israel Gelfand",1910,"2009",1," theory of differential equations"," biologist","UKR",99
"Adam Olearius",1600,"1671",0," physics"," linguist","DEU",71
"Paul Halmos",1910,"2006",1," set theory"," philosopher","HUN",96
"Felix Berezin",1930,"1980",0," group theory"," inventor","RUS",50
"Pierre-Simon Laplace",1740,"1827",1," mechanics"," physicist","FRA",87
"Carl Friedrich Gauss",1770,"1855",1," electrostatics"," astronomer","AUS",85
"Vasili Yakovlevich Zinger",1830,"1907",0," Q3968"," mathematician","RUS",77
"Galileo Galilei",1560,"1642",0," mathematics"," mathematician","COL",82
"Leonhard Euler",1700,"1783",0," astronomy"," musicologist","BEL",83
"Andrey Kolmogorov",1900,"1987",1," mechanics"," statistician","RUS",87
"Israel Gelfand",1910,"2009",1," theory of differential equations"," university teacher","UKR",99
"Adam Olearius",1600,"1671",0," physics"," librarian","DEU",71
"Paul Halmos",1910,"2006",1," set theory"," statistician","HUN",96
"Pierre-Simon Laplace",1740,"1827",1," mechanics"," politician","FRA",87
"Carl Friedrich Gauss",1770,"1855",1," electrostatics"," science writer","AUS",85
"Vasili Yakovlevich Zinger",1830,"1907",0," Q3968"," university teacher","RUS",77
"Galileo Galilei",1560,"1642",0," mathematics"," physicist","COL",82
"Leonhard Euler",1700,"1783",0," astronomy"," music theorist","BEL",83
"Andrey Kolmogorov",1900,"1987",1," mechanics"," university teacher","RUS",87
"Adam Olearius",1600,"1671",0," physics"," diplomat","DEU",71
"Pierre-Simon Laplace",1740,"1827",1," mechanics"," philosopher","FRA",87
"Carl Friedrich Gauss",1770,"1855",1," electrostatics"," physicist","AUS",85
"Galileo Galilei",1560,"1642",0," mathematics"," inventor","COL",82
"Leonhard Euler",1700,"1783",0," astronomy"," university teacher","BEL",83
"Adam Olearius",1600,"1671",0," physics"," translator","DEU",71
"Pierre-Simon Laplace",1740,"1827",1," mechanics"," university teacher","FRA",87
"Carl Friedrich Gauss",1770,"1855",1," electrostatics"," geodesist","AUS",85
"Galileo Galilei",1560,"1642",0," mathematics"," astrologer","COL",82
"Leonhard Euler",1700,"1783",0," astronomy"," writer","BEL",83
"Adam Olearius",1600,"1671",0," physics"," writer","DEU",71
"Pierre-Simon Laplace",1740,"1827",1," mechanics"," theoretical physicist","FRA",87
"Carl Friedrich Gauss",1770,"1855",1," electrostatics"," university teacher","AUS",85
"Galileo Galilei",1560,"1642",0," mathematics"," polymath","COL",82
"Leonhard Euler",1700,"1783",0," astronomy"," teacher","BEL",83
"Adam Olearius",1600,"1671",0," physics"," poet lawyer","DEU",71
"Galileo Galilei",1560,"1642",0," mathematics"," university teacher","COL",82
"Adam Olearius",1600,"1671",0," physics"," historian","DEU",71
"Galileo Galilei",1560,"1642",0," mathematics"," scientist","COL",82
"Galileo Galilei",1560,"1642",0," mathematics"," theoretical physicist","COL",82
"D. D. Morduhai-Boltovskoi",1870,"1952",0," mathematical logic","mathematician","KAZ",82
"Maryam Mirzakhani",1970,"2017",1," dynamical systems theory","mathematician","IRN",47
"Pierre-Simon Laplace",1740,"1827",1," astronomy","mathematician","FRA",87
"Boris Delaunay",1890,"1980",1," number theory","mathematician","RUS",90
"Carl Friedrich Gauss",1770,"1855",1," optics","mathematician","AUS",85
"Vasili Yakovlevich Zinger",1830,"1907",0," geometry","philosopher","RUS",77
"Alexander Friedmann",1880,"1925",1," pure mathematics","mathematician","RUS",45
"Pavel Alexandrov",1890,"1982",1," Function theory","mathematician","RUS",92
"Leonhard Euler",1700,"1783",0," physics","mathematician","BEL",83
"Andrey Kolmogorov",1900,"1987",1," measure theory","mathematician","RUS",87
"Mark Krein",1900,"1989",1," mathematical physics","mathematician","RUS",89
"Israel Gelfand",1910,"2009",1," probability theory","mathematician","UKR",99
"Maryam Mirzakhani",1970,"2017",1," dynamical systems theory"," topologist","IRN",47
"Pierre-Simon Laplace",1740,"1827",1," astronomy"," astronomer","FRA",87
"Boris Delaunay",1890,"1980",1," number theory"," university teacher","RUS",90
"Carl Friedrich Gauss",1770,"1855",1," optics"," geophysicist","AUS",85
"Vasili Yakovlevich Zinger",1830,"1907",0," geometry"," botanist","RUS",77
"Alexander Friedmann",1880,"1925",1," pure mathematics"," physicist","RUS",45
"Pavel Alexandrov",1890,"1982",1," Function theory"," university teacher","RUS",92
"Leonhard Euler",1700,"1783",0," physics"," physicist","BEL",83
"Andrey Kolmogorov",1900,"1987",1," measure theory"," computer scientist","RUS",87
"Mark Krein",1900,"1989",1," mathematical physics"," university teacher","RUS",89
"Israel Gelfand",1910,"2009",1," probability theory"," biologist","UKR",99
"Pierre-Simon Laplace",1740,"1827",1," astronomy"," physicist","FRA",87
"Carl Friedrich Gauss",1770,"1855",1," optics"," astronomer","AUS",85
"Vasili Yakovlevich Zinger",1830,"1907",0," geometry"," mathematician","RUS",77
"Leonhard Euler",1700,"1783",0," physics"," musicologist","BEL",83
"Andrey Kolmogorov",1900,"1987",1," measure theory"," statistician","RUS",87
"Israel Gelfand",1910,"2009",1," probability theory"," university teacher","UKR",99
"Pierre-Simon Laplace",1740,"1827",1," astronomy"," politician","FRA",87
"Carl Friedrich Gauss",1770,"1855",1," optics"," science writer","AUS",85
"Vasili Yakovlevich Zinger",1830,"1907",0," geometry"," university teacher","RUS",77
"Leonhard Euler",1700,"1783",0," physics"," music theorist","BEL",83
"Andrey Kolmogorov",1900,"1987",1," measure theory"," university teacher","RUS",87
"Pierre-Simon Laplace",1740,"1827",1," astronomy"," philosopher","FRA",87
"Carl Friedrich Gauss",1770,"1855",1," optics"," physicist","AUS",85
"Leonhard Euler",1700,"1783",0," physics"," university teacher","BEL",83
"Pierre-Simon Laplace",1740,"1827",1," astronomy"," university teacher","FRA",87
"Carl Friedrich Gauss",1770,"1855",1," optics"," geodesist","AUS",85
"Leonhard Euler",1700,"1783",0," physics"," writer","BEL",83
"Pierre-Simon Laplace",1740,"1827",1," astronomy"," theoretical physicist","FRA",87
"Carl Friedrich Gauss",1770,"1855",1," optics"," university teacher","AUS",85
"Leonhard Euler",1700,"1783",0," physics"," teacher","BEL",83
"D. D. Morduhai-Boltovskoi",1870,"1952",0," history of mathematics","mathematician","KAZ",82
"Vasili Yakovlevich Zinger",1830,"1907",0," mechanics","philosopher","RUS",77
"Leonhard Euler",1700,"1783",0," mechanics","mathematician","BEL",83
"Andrey Kolmogorov",1900,"1987",1," set theory","mathematician","RUS",87
"Israel Gelfand",1910,"2009",1," numerical analysis","mathematician","UKR",99
"Vasili Yakovlevich Zinger",1830,"1907",0," mechanics"," botanist","RUS",77
"Leonhard Euler",1700,"1783",0," mechanics"," physicist","BEL",83
"Andrey Kolmogorov",1900,"1987",1," set theory"," computer scientist","RUS",87
"Israel Gelfand",1910,"2009",1," numerical analysis"," biologist","UKR",99
"Vasili Yakovlevich Zinger",1830,"1907",0," mechanics"," mathematician","RUS",77
"Leonhard Euler",1700,"1783",0," mechanics"," musicologist","BEL",83
"Andrey Kolmogorov",1900,"1987",1," set theory"," statistician","RUS",87
"Israel Gelfand",1910,"2009",1," numerical analysis"," university teacher","UKR",99
"Vasili Yakovlevich Zinger",1830,"1907",0," mechanics"," university teacher","RUS",77
"Leonhard Euler",1700,"1783",0," mechanics"," music theorist","BEL",83
"Andrey Kolmogorov",1900,"1987",1," set theory"," university teacher","RUS",87
"Leonhard Euler",1700,"1783",0," mechanics"," university teacher","BEL",83
"Leonhard Euler",1700,"1783",0," mechanics"," writer","BEL",83
"Leonhard Euler",1700,"1783",0," mechanics"," teacher","BEL",83
"Leonhard Euler",1700,"1783",0," theory of differential equations","mathematician","BEL",83
"Andrey Kolmogorov",1900,"1987",1," differential calculus","mathematician","RUS",87
"Leonhard Euler",1700,"1783",0," theory of differential equations"," physicist","BEL",83
"Andrey Kolmogorov",1900,"1987",1," differential calculus"," computer scientist","RUS",87
"Leonhard Euler",1700,"1783",0," theory of differential equations"," musicologist","BEL",83
"Andrey Kolmogorov",1900,"1987",1," differential calculus"," statistician","RUS",87
"Leonhard Euler",1700,"1783",0," theory of differential equations"," music theorist","BEL",83
"Andrey Kolmogorov",1900,"1987",1," differential calculus"," university teacher","RUS",87
"Leonhard Euler",1700,"1783",0," theory of differential equations"," university teacher","BEL",83
"Leonhard Euler",1700,"1783",0," theory of differential equations"," writer","BEL",83
"Leonhard Euler",1700,"1783",0," theory of differential equations"," teacher","BEL",83
"Leonhard Euler",1700,"1783",0," mathematical physics","mathematician","BEL",83
"Andrey Kolmogorov",1900,"1987",1," functional analysis","mathematician","RUS",87
"Leonhard Euler",1700,"1783",0," mathematical physics"," physicist","BEL",83
"Andrey Kolmogorov",1900,"1987",1," functional analysis"," computer scientist","RUS",87
"Leonhard Euler",1700,"1783",0," mathematical physics"," musicologist","BEL",83
"Andrey Kolmogorov",1900,"1987",1," functional analysis"," statistician","RUS",87
"Leonhard Euler",1700,"1783",0," mathematical physics"," music theorist","BEL",83
"Andrey Kolmogorov",1900,"1987",1," functional analysis"," university teacher","RUS",87
"Leonhard Euler",1700,"1783",0," mathematical physics"," university teacher","BEL",83
"Leonhard Euler",1700,"1783",0," mathematical physics"," writer","BEL",83
"Leonhard Euler",1700,"1783",0," mathematical physics"," teacher","BEL",83
"Leonhard Euler",1700,"1783",0," computational mathematics","mathematician","BEL",83
"Andrey Kolmogorov",1900,"1987",1," philosophy of mathematics","mathematician","RUS",87
"Leonhard Euler",1700,"1783",0," computational mathematics"," physicist","BEL",83
"Andrey Kolmogorov",1900,"1987",1," philosophy of mathematics"," computer scientist","RUS",87
"Leonhard Euler",1700,"1783",0," computational mathematics"," musicologist","BEL",83
"Andrey Kolmogorov",1900,"1987",1," philosophy of mathematics"," statistician","RUS",87
"Leonhard Euler",1700,"1783",0," computational mathematics"," music theorist","BEL",83
"Andrey Kolmogorov",1900,"1987",1," philosophy of mathematics"," university teacher","RUS",87
"Leonhard Euler",1700,"1783",0," computational mathematics"," university teacher","BEL",83
"Leonhard Euler",1700,"1783",0," computational mathematics"," writer","BEL",83
"Leonhard Euler",1700,"1783",0," computational mathematics"," teacher","BEL",83
"Leonhard Euler",1700,"1783",0," ballistics","mathematician","BEL",83
"Andrey Kolmogorov",1900,"1987",1," computational linguistics","mathematician","RUS",87
"Leonhard Euler",1700,"1783",0," ballistics"," physicist","BEL",83
"Andrey Kolmogorov",1900,"1987",1," computational linguistics"," computer scientist","RUS",87
"Leonhard Euler",1700,"1783",0," ballistics"," musicologist","BEL",83
"Andrey Kolmogorov",1900,"1987",1," computational linguistics"," statistician","RUS",87
"Leonhard Euler",1700,"1783",0," ballistics"," music theorist","BEL",83
"Andrey Kolmogorov",1900,"1987",1," computational linguistics"," university teacher","RUS",87
"Leonhard Euler",1700,"1783",0," ballistics"," university teacher","BEL",83
"Leonhard Euler",1700,"1783",0," ballistics"," writer","BEL",83
"Leonhard Euler",1700,"1783",0," ballistics"," teacher","BEL",83
"Leonhard Euler",1700,"1783",0," optics","mathematician","BEL",83
"Andrey Kolmogorov",1900,"1987",1," mathematical statistics","mathematician","RUS",87
"Leonhard Euler",1700,"1783",0," optics"," physicist","BEL",83
"Andrey Kolmogorov",1900,"1987",1," mathematical statistics"," computer scientist","RUS",87
"Leonhard Euler",1700,"1783",0," optics"," musicologist","BEL",83
"Andrey Kolmogorov",1900,"1987",1," mathematical statistics"," statistician","RUS",87
"Leonhard Euler",1700,"1783",0," optics"," music theorist","BEL",83
"Andrey Kolmogorov",1900,"1987",1," mathematical statistics"," university teacher","RUS",87
"Leonhard Euler",1700,"1783",0," optics"," university teacher","BEL",83
"Leonhard Euler",1700,"1783",0," optics"," writer","BEL",83
"Leonhard Euler",1700,"1783",0," optics"," teacher","BEL",83
